книга: книга
изюм: изюмом
смузи: смузи
поддерживать: поддержать
мясо: мясом мясо
соевый: соевый соевое соевым
коктейль: коктейли
картошка: картошки
красный: красной
адыгейский: адыгейским
гхи: гхи
сладость: сладости
сайт: сайте
raw: raw
панир: панир
закуска: закуски закусок
тыквенный: тыквенный
пожертвовать: пожертвовать
огурцов: огурцов
напиток: напитков напитки
сок: сока
фасоль: фасолью
цветной: цветная
сыр: сыром
квасить: квашенной
соус: соусы
яйцо: яиц
овощной: овощные
суп: супов супы
салат: салат салаты салатов
свекла: свеклы
грецкий: грецкими
запись: записям записи
чернослив: черносливом
котлета: котлеты
печение: печенья
производить: производим
перец: перец
post: post
метка: метки
духовка: духовке
r: rss
вкусно: вкусно
содержимый: содержимому
навигация: навигация
ruchi: ruchi
домашний: домашний
агар: агаре
орех: орехами
капуста: капустой капусты капуста
пельмень: пельмени
вегетарианский: вегетарианские
рис: рис рисом
кекс: кекс
рецепт: рецептов рецепты рецепт
сметана: сметаной
безалкогольный: безалкогольный
кокосовый: кокосовой
предыдущий: предыдущие
веганский: веганский веганские
продукт: продукты
рубрика: рубрики
mayo: mayo
проект: проект
сухой: сухим
пирогов: пирогов
sidebar: sidebar
интересно: интересно
мармелад: мармелад
куркума: куркума
избранный: избранное
toggle: toggle
чечевичный: чечевичные
финик: финиками
уникальный: уникальный
глинтвейн: глинтвейн
морковь: моркови
поиск: поиск
гуляш: гуляш
молоко: молоком
мимоза: мимоза
подписка: подписка
кэроб: кэроб
веган: веган
ги: ги
лента: лента
вкусняшка: вкусняшек
завтрак: завтраки
находить: найти
корица: корицей
готовить: готовим
сыроедческий: сыроедческие
манта: манты
читать: читать
переходить: перейти
майонез: майонез
винегрет: винегрет
нут: нут
помидор: помидоры
десерт: десерты
меню: меню
молочный: молочные
яблоко: яблоками
творог: творога
ролл: роллов
content: content
нори: нори
плов: плов
стружка: стружкой
выпечка: выпечка
далее: далее
экадаши: экадаши
электронный: электронная
сабджи: сабджи
баклажан: баклажаны
блюдо: блюда
банан: бананами
новый: новые
болгарский: болгарский
тоф: тофу
оливье: оливье
кабачок: кабачки
