два: двумя двух две
эксплуатация: эксплуатация эксплуатации
вставать: встал
td: td
хотеть: хочет хотели
классика: классика
автомобиль: автомобилем автомобилей автомобили автомобиля автомобилю автомобиль
free: free
транслироваться: транслируется
знать: знаете
ameri: ameri
панорамный: панорамными
интересный: интересный интересных интереснейших интересные интересной интересное
подробно: подробнее подробно
планета: планете
место: места мест месте местах местом место
хороший: лучшими лучших лучшая хорошим лучшей лучшего лучшее лучший хорошей лучшим лучшем лучшие
результат: результат
устанавливать: устанавливать устанавливаемые
радостный: радостные
свобода: свободы свободу
пол: полом пол
покрытие: покрытие покрытием
thor: thor
поехать: поехать
саха: сах
двухосный: двухосном двухосные двухосных двухосный
круг: круг
bhsl: bhsl
mover: mover
ответ: ответ
cff: cff
полный: полного полную полном полная полный
серия: серий серия серии
кондиционер: кондиционер кондиционера кондиционером
прицеп: прицепов прицеп прицепом прицепа прицепах прицепе прицепами прицепы
быстрый: быстрые быстрый
возможность: возможностью возможности
самый: самый самым самая самом самой самых самые
жилой: жилой жилое жилым
небольшой: небольшие небольшими небольших небольшой
прелесть: прелесть
продажа: продажа продаже продажей продаж
дешевый: дешевые дешевый
xt: xt
свободный: свободных свободным
очень: очень
семья: семьей семьи семей
материал: материала материалов материалы
такой: такие
клиренс: клиренс клиренсом
администрация: администрации
гостиница: гостиницы гостиницу гостиница
дилер: дилер
получать: получить
интересно: интересно
спальня: спальню спальней спальни спальне
вольт: вольт
минималистичный: минималистичного
прекрасный: прекрасного
система: систему система системы
kr: kr
увеличивать: увеличенным увеличенный
делиться: делится
сзади: сзади
миллион: миллионов
разный: разная
редкий: редкая
просторный: просторный просторного просторной просторное просторным
краснодар: краснодаре
ultralite: ultralite
тип: типов
договор: договор
дорогой: дороже дорогой дорогие
apex: apex
grand: grand
кино: кино
удобный: удобные удобной удобная
колесо: колесах
бренд: бренды
пространство: пространство пространства
кемпинг: кемпинги кемпинге кемпинг кемпинга
сочетание: сочетание сочетанием
fu: fu
обычный: обычные обычный обычному
холодильник: холодильник холодильником
отель: отели отеля отель отелей
bh: bh bhs
закачивать: закачать
rb: rbss rb rbs
размер: размере размер
поставлять: поставить поставили поставив
завидовать: завидуют завидует
рама: рамой
новое: новое нового
безопасность: безопасность
ваш: вашего ваши ваш вашим вашей
отвечать: отвечает
высокий: высокой высоким высокими высокая
k: k
электричество: электричеством электричества
uf: uf
россия: россии россию
простой: простой простого
квадроцикл: квадроцикла квадроциклом квадроциклов
bo: bo
включая: включая
пресса: пресса
бу: бу
борт: бортом
канал: канала
входной: входные
tr: tr
внешний: внешних внешняя внешний внешней
буксировка: буксировка буксировки
встречаться: встретился
цена: цене цена цен
аналог: аналоги аналог аналогов
новый: новейших новый новая новые новой
express: express
гостинный: гостинной
дача: дача дачи дачей дач дачу дачами
кровать: кроватями кровати кроватью кровать
центр: центр центре
обзор: обзор обзора
спальный: спальных
скутер: скутера
сервис: сервис
зимний: зимние зимних зимний
автодом: автодомом автодом автодоме автодома автодомах автодомов
красота: красоты
outback: outback
мотоцикл: мотоцикл мотоциклом мотоцикла
аналитический: аналитическое
один: одним одной одного одно одна одну
караван: каравана караваны караваном караванов караване каравану караван
предложение: предложения предложение
данный: данных
умный: умный
дешево: дешевле
производитель: производителей
вывозной: вывозной
душа: душа
путешествие: путешествий путешествия путешествие путешествии
приглашать: приглашает приглашаем
невысокий: невысокой
купить: куплю купить
jay: jay
impact: impact
вид: вида виды
территория: территории
длительный: длительное
edition: edition
sydney: sydney
полуинтегрировать: полуинтегрированная полуинтегрированные
bqt: bqt
дом: домах домов дому дом домами доме домом
тягач: тягачей тягачу тягача тягачи тягач
автономность: автономность
русский: русском русской
внедорожный: внедорожных внедорожного внедорожные внедорожный
сочетаться: сочетающиеся
тепло: тепле тепло
север: севера
постоянно: постоянно
сказка: сказок
forest: forest
солнечный: солнечные солнечных
друг: друзья друзей друзьями другом
masterline: masterline
российский: российский российским российских российские
глянцевый: глянцевой глянцевая
villa: villa
перевозка: перевозки
покупатель: покупателя покупатель покупателю
намного: намного
ч: ч
снабжение: снабжение
виза: визу визы
европейский: европейские европейских европейский европейского
легко: легко
индивидуальный: индивидуальный индивидуального
открывать: откроете открывать
сайт: сайта сайте
geo: geo
rbk: rbk
доступный: доступный доступен
обслуживание: обслуживанием
широкий: широким широкой
январь: января
краткий: краткий
оснащать: оснащены
буксировать: буксировать
оферта: оферта
подробный: подробнейший подробное подробный
vivo: vivo
американский: американские американский американской американского американских американском
участвовать: участвовал
детский: детскими детские детским детской
sandvika: sandvika
огромный: огромный огромная
кол: кол
blf: blf
deluxe: deluxe
крутой: круче
слайдер: слайдерами слайдером слайдер
состояться: состоится
прием: приемов прием приема
древний: древнего
работа: работа
координата: координатами координата
ялта: ялта ялты ялте
дело: дело дел
сравнение: сравнение сравнению
двухъярусный: двухъярусной двухъярусные
например: например
правило: правило
дорога: дороге дорогам дорогу дорог
источник: источников источники
крайний: крайнего
уют: уют уюта
который: которых которыми который которая которого котором которой которые
жить: живете жить
premiere: premiere
задний: заднего задней задними
движение: движении движение
ребенок: детей детьми ребенка
мы: нам нами
отапливать: отапливать
опыт: опыт
beachy: beachy
нагрузка: нагрузки нагрузкой
излюбленный: излюбленном
beauer: beauer
мороз: мороз морозы
боржоми: боржоми
неповторимый: неповторимый
зрение: зрения
монтаж: монтажа
путешествовать: путешествовать путешествуем путешествуйте путешествуя
сказать: сказать
бак: баки баках бак
делать: делает делают
английский: английского
площадка: площадке площадку площадок площадка
серебристый: серебристый
курортный: курортном
температура: температуру температуре температура
bullet: bullet
transgent: transgent
кругосветный: кругосветного
оригинальный: оригинальный
fun: fun
привозить: привезти
установка: установки установка
владелец: владельцу владелец владельцев владельцам
kmfe: kmfe
go: go
hymer: hymer
bhxl: bhxl
автофургон: автофургоны
управление: управление управления
видеобзор: видеобзор
этот: этих
давать: дают дает давайте
модель: моделях модель модели
отношение: отношении
стена: стены стенами
гость: гости гостей
ukfe: ukfe
легкий: легкий легкого легкой
сколько: сколько
брать: брать берите
зима: зимой зимы зим
деньги: деньги
город: городу городе город городом города
разрешать: разрешенный
остров: островом островах
магазин: магазин
выбирать: выбираю выбрать
девять: девять
bushwhacker: bushwhacker
вносить: вносите
дверь: дверь двери дверью
туристический: туристических
бывать: бывает
белый: белый белая
присутствие: присутствия
ехать: едет еду едут
вариант: вариант вариантов варианта
питание: питание
завод: заводе завода
выглядеть: выглядит
осматривать: осматривает
успевать: успейте
оборудование: оборудованием оборудование оборудования
пока: пока
превращаться: превращаться превращается
несмотря: несмотря
домик: домик
риторический: риторический
ценитель: ценителей
усиление: усиления
флагман: флагмана флагман
вдвоем: вдвоем
некоторый: некоторое
контакт: контакты
июль: июля
репортаж: репортаж
популярный: популярный популярных популярная популярного
коннектор: коннектор
крым: крыму крыма крым
прекрасно: прекрасно
вне: вне
опция: опциями опции опций
принимать: принимаем принимает принять
рассказ: рассказ
uhl: uhl
joy: joy
отслеживать: отследить
независимый: независимых независимый
al: al
компания: компании компания
landhouse: landhouse
научаться: научились
sv: sv
кухонный: кухонная кухонным
день: дней днем дня
transcend: transcend
жара: жары
двуспальный: двуспальная
рубль: рублей
рано: раньше
караванинг: караванинга караванинг
туалет: туалет туалетом
планировка: планировки планировкой планировку планировок планировка
концепция: концепцией
точка: точки
усиленный: усиленной усиленные
сoleman: сoleman
аренда: аренду аренда
фильм: фильма
близкие: близких
организовывать: организовать организовывает организованном
другой: другие другое других
изменение: изменения
невероятно: невероятно
метр: метрах
отправка: отправки отправкой отправка
df: df
единственный: единственный
обновление: обновление
статья: статьи
компактный: компактного компактные компактный
шар: шар
сидение: сидений
prime: prime
подготовка: подготовка
создавать: создают создан созданы создали
hobby: hobby
прорезиненный: прорезиненное
новинка: новинка новинки
гриль: грилем
обходиться: обойтись
htd: htd
аккумулятор: аккумуляторов аккумулятор
доп: допов
prism: prism
peugeot: peugeot
нога: нога
обшарпывать: обшарпанном
почему: почему
осень: осенью
поселять: поселят
проходимость: проходимостью проходимости проходимость
проезд: проезд
интегрировать: интегрированных интегрировано интегрированные
хватать: хватает
transcent: transcent
супружеский: супружеской
пневмоподвеска: пневмоподвеской
fr: fr
кабина: кабиной
улучшать: улучшенной улучшенный
g: g
отличие: отличие отличия
край: края
приключенческий: приключенческое
кухня: кухня кухней
позволять: позволяет позволяющее позволяют позволяющая
dbh: dbh
e: e
колесаз: колесаз
караванер: караванеры караванера караванерам караванеров
серый: серой серый
специалист: специалист
внутри: внутри
bhxk: bhxk
именно: именно
атлантический: атлантической
генератор: генератор
запрещать: запрещено запрещена
проводить: провести
clipper: clipper
отделка: отделкой отделка
видео: видео
неограниченный: неограниченной
испытывать: испытать
одноосный: одноосного одноосный одноосном
limited: limited
djse: djse
открытый: открытый открытой
стоять: стоять стоит
kmf: kmf
передовой: передовых передовые
условие: условиям условиях
шкаф: шкафом
машина: машины машине машин
рыбалка: рыбалка рыбалки
зона: зоной зонах
бюджетный: бюджетный
граница: границей границ
mercedes: mercedes
душ: душем душ
лофотенский: лофотенских
столик: столик столиком
скромный: скромном
спутниковый: спутниковое
королевский: королевский королевская королевской
велосипед: велосипеда велосипедов
раздельный: раздельными
сеть: сеть
маркиза: маркизой маркизы
вода: воды водой вода
ontour: ontour
море: море моря
rockwood: rockwood
любить: любите
чувство: чувство
относительно: относительно
river: river
практичный: практичная
соотношение: соотношений
черноморский: черноморскому
elite: elite
уличный: уличной
весь: всей
дополнительный: дополнительного дополнительной дополнительными дополнительных дополнительные дополнительное
становиться: становитесь становится стал
надежный: надежной
пакет: пакет
согласие: согласия
трум: трума
помощь: помощи помощью
цельный: цельным
er: er
salem: salem
бесплатно: бесплатно
наружный: наружной
отопление: отопление
qmk: qmk
парковка: парковки
старый: старого
удивлять: удивит
простор: простора
freedom: freedom
поездка: поездки поездка
максимальный: максимальная максимальным
фильтр: фильтром
uff: uff
черный: черный черного черной черном
красивый: красивый красивым красивой
просто: просто
kwfu: kwfu
идеально: идеально
th: th
стоянка: стоянок стоянки стоянке стоянка
диапазон: диапазон
поляна: поляна
ниша: нише ниша
fc: fc
грузия: грузию грузии
uhk: uhk
перевозить: перевозить
капля: капли
deseo: deseo
r: rss rs r
г: г
перевод: перевод
обучение: обучение
review: reviews
домой: домой
доставка: доставка доставку
семейный: семейных семейный семейная семейные семейном семейного
exclusiv: exclusiv
уникальный: уникальный уникальные
слива: слив
lu: lu
вход: входами входа входом
торговый: торговый
решать: решать
насос: насоса
награда: наград
персональный: персональных
wlu: wlu
дорожный: дорожным
h: h
большой: большой больших большим большого большие
элитный: элитный элитного
стоимость: стоимость
рядом: рядом
зависеть: зависит
занавеска: занавеской
отдыхать: отдыхаете отдыхать
мочь: могут
установленный: установленных установленные
нужный: нужен нужны нужна
информация: информации
наиболее: наиболее
вернуться: вернулся
существовать: существует
композитный: композитных
fiat: fiat
кг: кг
стол: стола столом
plus: plus
cellini: cellini
ванная: ванную
cg: cg
бездорожье: бездорожья
теплый: теплая теплый теплым
заправка: заправка
микроклимат: микроклимат
история: история
avenger: avenger
норвегия: норвегию норвегия
wfb: wfb
дилерский: дилерские
крепкий: крепкой
музыка: музыка
комната: комнатами комнаты комнатой комнату
ниспадать: ниспадающую
совет: советы
lmc: lmc
газ: газа
комфорт: комфорта комфорт
сетка: сетки
культовый: культового
интенсивный: интенсивной
ощущение: ощущение
европа: европа европе европу
необходимый: необходимым
готовый: готов
travel: travel
электролап: электролапами
изолированный: изолированной
sky: sky
суровый: суровой суровых
год: году года год лет
главное: главное
понимать: понимать
оставаться: осталось оставаться
гид: гид
bt: bt
подходить: подходят
sprinter: sprinter
идеальный: идеальный идеальное идеален идеальные
hike: hike
внутренний: внутреннее
фаркоп: фаркопа
серийный: серийного серийные
район: районов
крепление: крепление
легкое: легкие легких
vivaldi: vivaldi
разрабатывать: разработали
специальный: специального
group: group
white: white
кстати: кстати
техника: техникой
механизм: механизмов
контроль: контроля
арктический: арктическое арктическом арктический
rkpr: rkpr
немного: немного
анталий: анталию
функциональность: функциональности
camper: camper
продавать: продаваемый
qbxl: qbxl
возможно: возможно
часть: части часть
звезда: звезд
lifestyle: lifestyle
landhaus: landhaus
клиент: клиенту клиентов
retro: retro
охранный: охранные
иметь: имеют имеет имеющей
rls: rls
наш: наших нашей наша
dwind: dwind
привод: привода привод
совершенно: совершенно
прочность: прочность
каравнинг: каравнинга
первый: первое первая первый первые
душевая: душевой
альковый: альковые
двигать: двигающее
сделать: сделанный сделаны сделать
копирование: копирование
оперативный: оперативный
адаптация: адаптации адаптация
renault: renault
современный: современному современном современная современного современные
knaus: knaus
выдерживать: выдерживал
бронза: бронза
хранение: хранения
heartland: heartland
кладовка: кладовкой кладовку
платный: платном
западный: западной
это: это этим
sf: sf
youtube: youtube
пляж: пляже
модуль: модулем
двухярусный: двухярусными
мебель: мебелью
gulf: gulf
пещерный: пещерного
скрытый: скрытым
потолок: потолками потолков
красавец: красавец
увеличенныем: увеличенныем
дома: дома
особняк: особняки
силовой: силового
tv: tv
фургон: фургоны
никак: никак
модельный: модельного модельный
cl: cl
фантастический: фантастической
bk: bk
маленький: маленький маленькими
подключение: подключения
свой: своем своим своей свои свой
способ: способ
октябрь: октября
мир: мире мир
запрет: запретов
pro: pro
выдвижной: выдвижной
truma: truma
coachman: coachmen
рыболовный: рыболовном
rm: rm
нужно: нужно
комн: комн
лето: лето
туда: туда
парковать: парковать
обеденный: обеденных обеденной
ссылка: ссылки
l: l
финляндия: финляндии
видеообзор: видеообзора видеообзор видеообзоры
оборудовать: оборудованные оборудованных
cruise: cruise
отсек: отсек
tab: tab
xg: xg
чемодан: чемоданы
сложный: сложное
rk: rk
германия: германии
b: b
amerilite: amerilite
практически: практически
отбирать: отобранный
инновационный: инновационный инновационной
полезный: полезные полезной
сутки: сутки
обогревать: обогреваемые
пульт: пульта
специально: специально
уменьшать: уменьшить
получение: получение получения
внук: внуков
sport: sport
номер: номере
ночевать: ночуем
градус: градусов
moderncomfort: moderncomfort
набор: набором
выдвигать: выдвигаемые
охота: охоты
электрооборудование: электрооборудование
анонс: анонс
kfu: kfu
dr: dr
палатка: палаткой палатка
помещаться: поместилось
вилла: вилла виллу
телевизор: телевизора
dethleffs: dethleffs
официальный: официальный
наличие: наличием наличии
шум: шум
туалетный: туалетной
сша: сша
партнер: партнер
улица: улице
тролль: троллей
мувер: мувер мувера
передача: передача передачи
mini: mini
каталог: каталог
hawk: hawk
интернет: интернет
лапа: лапы
москитный: москитные
отдых: отдыха отдых
q: qs
альков: алькова
бизнес: бизнеса
участок: участка участок
линейка: линейка
загар: загар
rbts: rbts
основывать: основана
действие: действий
трехосный: трехосные
складываться: складываться
keyston: keyston
дальний: дальние
maxia: maxia
таскать: таскать
keystone: keystone
снаружи: снаружи
trailer: trailer
быть: будь
приемка: приемка
великолепный: великолепного
батарея: батарей батареи
d: ds
удостоить: удостоенного
explorer: explorer
процедура: процедуру
описание: описании
себя: собой
отдельный: отдельной отдельным
выходной: выходной выходного
запад: западе
совершенство: совершенство
qbs: qbs
необычный: необычный
ценный: ценных
sudwind: sudwind
человек: людей человек
утепление: утепление
впечатление: впечатления впечатлениями
любой: любого любой любых
excellent: excellent
предлагать: предлагает
бежевый: бежевый
wolf: wolf
местный: местный местным
вечер: вечером
камера: камера камеры
flight: flight
показывать: показывающий показываем показана
повышенный: повышенная повышенной
crossover: crossover
комфортный: комфортную
de: de
осенний: осенний
тбилиси: тбилиси
атмосфера: атмосферой
davinci: davinci
маркиз: маркиза
глубоко: глубоко
ql: ql
скандинавский: скандинавский скандинавского
phoenix: phoenix
офигеть: офигеют
время: время временем
экономить: экономить
автоматический: автоматическая автоматической
kodiak: kodiak
заниматься: заниматься
ml: ml
отличаться: отличаются
точно: точно
спонтанный: спонтанная
ширина: ширину
плато: плато
продумывать: продуманной
жизнь: жизни
использование: использования
бескомпромиссный: бескомпромиссных
некоторые: некоторые
участие: участие
сам: само самого
посещать: посетить
omni: omni
пример: пример примерах примере
вытяжка: вытяжка
предлагаться: предлагается
подбор: подбор подбора
pure: pure
cfe: cfe
минута: минуты
санузел: санузлом
соцсеть: соцсетях
услышать: услышать
качественный: качественнее
сладер: сладере сладером
инфраструктура: инфраструктуры инфраструктура
новичок: новичка новичкам
актуальный: актуальное
grey: grey
осуществляться: осуществляется
выбор: выбор выборе
тв: тв
испытание: испытания
политика: политика
ставка: ставку
хилтон: хилтон
проверка: проверка
ездить: ездили
toyota: toyota
nomad: nomad
rv: rv
путешественник: путешественников
prestige: prestige
класс: класс
sfe: sfe
важный: важные
достигаться: достигается
c: c
ряд: ряд
коричневый: коричневый
кузов: кузовом
автономный: автономный автономное
вообще: вообще
canyon: canyon
riverside: riverside
парковаться: парковаться паркуются
fk: fk
автономка: автономкой
комби: комби
свес: свесами
tailgator: tailgator
конфорка: конфорки
f: fs
stream: stream
несколько: несколько
rks: rks
двухдверный: двухдверный
цвет: цвет цвета
kd: kd
инсталляция: инсталляция
иной: иной
правильно: правильно
crossfire: crossfire
slc: slc
какой: какие
sap: sap
баллон: баллонах
проживание: проживания
решение: решениями
дизайн: дизайна дизайн
расстояние: расстояния
й: й
л: л
смотреть: смотреть
шасси: шасси
маневренный: маневренные
москва: москве
познавать: познав
холодный: холодная
premier: premier
словом: словом
мини: мини
казань: казань
гараж: гаражом
сова: сова
агрегат: агрегата
электропривод: электроприводом
braxton: braxton
qsk: qsk
идти: идет
generation: generation
полярный: полярный
план: план
целый: целый
разбираться: разбираются
двойной: двойные
сентябрь: сентября
аксессуар: аксессуары аксессуаров
около: около
minilite: minilite
benz: benz
дорогущий: дорогущие
пять: пять
минивен: минивены
женщина: женщины
качество: качество
база: базе
fks: fks
pioneer: pioneer
перемещение: перемещения
последний: последнее
неведомый: неведомый
qlk: qlk
дизайнерский: дизайнерская
интеллектуальный: интеллектуальными
рф: рф
рыбачий: рыбачье
обычно: обычно
недорогой: недорогих недорогой
уютный: уютный уютном
luxe: luxe
готовить: готовите
приобретение: приобретений
безопасный: безопасный
ставить: ставить
конфигуратор: конфигуратором
vintage: vintage
т: т
смартфон: смартфон
солнце: солнце
продаваться: продается
водоснабжение: водоснабжение
начинать: начать начала
зайти: зайдя
fe: fe
одноименный: одноименная
количество: количества количеством
приятно: приятно
любитель: любителей
sff: sff
mallard: mallard
db: db
основной: основных
boundary: boundaries
романтический: романтической
озеро: озера
усовершенствовать: усовершенствуете
хозяин: хозяев
особенность: особенности особенностей
взять: взять взяли
регион: регион
высота: высота
монастырь: монастыря
jayco: jayco
ford: ford
ковер: ковров ковры
ти: ти
начинаться: начинается
второй: второго
wfc: wfc
ascent: ascent
морской: морское
rl: rl
полностью: полностью
опасаться: опасаться
бесплатный: бесплатную
подвозить: подвезти
окончательный: окончательный
видеокамера: видеокамеры
энергия: энергии
панель: панель
гкиа: гкий
tramp: tramp
поставка: поставка
coleman: coleman
автоматически: автоматически
пара: пары
допы: доп
подушка: подушкой
сочетать: сочетающий
печка: печкой
metropolis: metropolis
starcraft: starcraft
umfe: umfe
мало: мало
ul: ul
магистраль: магистралях
nobo: nobo
узкий: узких
видеоинструкция: видеоинструкция
потянуть: потянет
сюда: сюда
супер: супер
lite: lite
fkr: fkr
больший: большая
устройство: устройство
rdl: rdl
tabbert: tabbert
rd: rd
супермаркет: супермаркет
двухместный: двухместном
присоединяться: присоединяйтесь
cruiser: cruiser
удобно: удобнее
знаменитый: знаменитая знаменитого
технология: технологии технологий
различный: различных
др: др
аквапарк: аквапарком
крыша: крыша
rfk: rfk
радиоуправляемый: радиоуправляемого
масса: масса
ванна: ванной
rbpr: rbpr
раз: раза
горячий: горячая
месяц: месяц
премиум: премиум
прямо: прямо
свое: свое
xplor: xplor
свет: света
уплисцихе: уплисцихе
стандарт: стандарты
fuzion: fuzion
крик: крики
двухфункциональный: двухфункциональной
lc: lc
хозяйка: хозяйки
раздвижной: раздвижными
slide: slide
держатель: держатель
диван: диваном
соприкосновение: соприкосновения
собственный: собственном
знакомство: знакомство
телевидение: телевидение
дождь: дождя
dl: dl
конструкция: конструкции
тепловой: тепловой
бояться: боится
впервые: впервые
побережье: побережью
юг: юге
обработка: обработки
посередине: посередине
springdale: springdale
hurricane: hurricane
потратить: потратив
fd: fd
д: д
wqc: wqc
сравнивать: сравниваем
уборка: уборки
ufe: ufe
exclusive: exclusive
полуприцеп: полуприцепа
эркер: эркерами
искать: искать
духовка: духовкой духовка
вопрос: вопросы вопрос
завеса: завесой
горный: горным
весенний: весенней
time: time
многий: многих
ko: ko
активный: активного
чистка: чистки
парк: парк
интерьер: интерьера
вездеход: вездеход
напротив: напротив
помещение: помещений
exsis: exsis
ufk: ufk
познакомиться: познакомьтесь
tft: tft
преграда: преград
увеличение: увеличения
ozark: ozark
городской: городской
располагать: расположена
копейка: копейки
заезд: заезд
август: августа
краснодарский: краснодарского
сигнализация: сигнализация
повседневный: повседневной
высокопроходимый: высокопроходимый
гора: горах
фото: фото
пользоваться: пользоваться
geopro: geopro
maestro: maestro
гибкий: гибкой
alde: alde
premium: premium
x: x
идентификатор: идентификаторы
возвращаться: возвращаетесь
выпуск: выпуска
le: le
вес: вес
рессорный: рессорной
ознакомление: ознакомления
натуральный: натуральные
евро: евро
двое: двоих
называться: называется
все: всем
шикарный: шикарный
изображение: изображение
alpha: alpha
находиться: находясь
dd: dd
хотеться: хочется
подножие: подножья
маломощный: маломощным
правильный: правильная
passport: passport
классический: классическая
многоместный: многоместный
ultra: ultra
представлять: представим
водительский: водительской
период: период
обратно: обратно
мощный: мощной
пляжный: пляжной
winnebago: winnebago
многодетный: многодетной
роскошный: роскошный
променивать: променяете
подписчик: подписчиков
живописный: живописном
строгий: строгая
х: х
дооборудовть: дооборудовть
wfu: wfu
кронштейн: кронштейн
lk: lk
немой: нем
зацеп: зацеп
prme: prme
