полезный: полезные
мадагаскар: мадагаскар
коммуникация: коммуникации
ваш: вашего ваш
воспитанник: воспитанников
ровесник: ровесниками ровесников
детский: детский детском детское детскому
появляться: появится
рождение: рождения
авторизоваться: авторизоваться
аппликация: аппликация
ребенок: ребенка детей дети ребенку ребенок
различный: различные
именно: именно
привыкать: привыкает
непосещение: непосещения
важно: важно
занятие: занятия занятиях
сад: сад сада саду садов
перерасчет: перерасчета
главный: главная
количество: количество
требовать: требующих требует
посвящать: посвящать
ясли: ясли
порядок: порядку
ответ: ответ
компенсироваться: компенсируется
попадать: попадет
полный: полного полный полная
неоценимый: неоценимые
новосибирск: новосибирске новосибирска
гарантировать: гарантируем
одеваться: одеться
прогулка: прогулке прогулка
создавать: создано
новое: новое
развивающийся: развивающийся
аспект: аспектом
очень: очень
позволять: позволяет
распорядок: распорядок
приятно: приятно
условие: условия условий условиях
адаптация: адаптацию адаптация
почасовой: почасовое
выбор: выбора
небольшой: небольшое
общение: общению общении
старший: старшие
проходить: проходит пройти
сожаление: сожалению
рука: руками
безопасность: безопасности безопасность
развитие: развития развитии развитию
очередь: очередь
система: система
максимально: максимально
сверстник: сверстники сверстниками
договариваться: договориться
каждый: каждые каждый каждого каждой каждому
педагог: педагог
деньги: денег
особенность: особенностей
неполный: неполный неполная
возможный: возможна
частный: частный частных
развиваться: развивались
подготовить: подготовленных
исходить: исходя
получать: получит получать
смочь: сможет
нужный: нужны
речь: речь
график: график
творчество: творчество
садик: садик
мама: мама
семья: семье семья
личность: личности
здоровье: здоровье
безопасный: безопасной
наш: наших наш нашего
родитель: родителей родителю
дальнейший: дальнейшего
запас: запаса
позаботиться: позаботимся
свой: своими своей свои своих своего свой
открытие: открытия
который: которые
развивать: развивающие развить
любить: люблю
знание: знаний
игра: играх игры игр
высокий: высшее
весело: весело
приводить: приводите
воспитывать: воспитываю
общество: обществе
отношение: отношение
набирать: набираем
ходить: ходить
раздеваться: раздеться
выходить: выйти
новый: новых новый
малыш: малыша малышам малышу малыш
оплата: оплаты
центр: центре
приходить: приходите приходят
возраст: возрасте
максимум: максимум
комментарий: комментария комментарий
благоприятный: благоприятных
среда: среды среду среде
владимировна: владимировна
должный: должны
получаться: получается
информация: информацию
раскрывать: раскрыть
находить: находить найдет
случай: случае
плюс: плюсом
опытный: опытные
весь: вся
воспитание: воспитания воспитание
путешествовать: путешествовать
материал: материалов
формирование: формирование
разработка: разработка
подходить: подошла
семейный: семейная
впечатление: впечатления
аккуратный: аккуратным
уютный: уютный
счет: счет
подбирать: подберем
год: года год лет
удобный: удобный
помогать: помогают поможем
друг: друзей
стоимость: стоимость
гулять: гуляем
комфортный: комфортную
ребятишки: ребятишки ребятишек
роща: роща
свое: свое
мочь: могут
вс: вс
сложный: сложный
оказывать: оказывать
мечтать: мечтают
креативный: креативные
потребность: потребностей
обучение: обучения
познавать: познавать
навык: навыков
учиться: учиться учимся
заводить: заводить
также: также
кушать: кушать
парк: парке
метод: метод
переходить: перейти
возможность: возможности возможность
работа: работы работу
монтессорить: монтессори
цена: цене цены цена
меню: меню
уметь: умеет
проводить: проводим
ребеночек: детки
самостоятельность: самостоятельность
музыка: музыка
индивидуальный: индивидуальный индивидуального индивидуальном
уровень: уровень
легко: легко
совет: советы
разнообразный: разнообразный
помещение: помещения
физический: физические
посещение: посещения
лепка: лепка
сытый: сыты
общаться: общаться
оставлять: оставьте
считать: считаю
весомый: весомое
это: это
компромисс: компромиссы
день: день дни дня
главное: главное
группа: группе
особый: особое особой
ознакомление: ознакомление
всесторонний: всестороннего
скорректировать: скорректировать
должность: должность
содержимый: содержимому
создание: создание
еда: еда
интерес: интересы
мы: нам
рисование: рисование
корректировать: корректировать
пребывание: пребывание
время: время времени
выходной: выходные
непринужденный: непринужденно
проводиться: проводится
делать: делают
немаловажный: немаловажным
поделка: поделки
регулярно: регулярно
окончание: окончания
диета: диеты
чувствовать: чувствовал
образование: образование
пропуск: пропусках
игрушка: игрушек
метро: метро
ждать: ждать
ранний: раннему
удовольствие: удовольствием
зимний: зимняя
березовый: березовая
природа: природой
научаться: научится
маленький: маленьких
задача: задачей
свободный: свободное
большой: большое
казаться: казалось
галерея: галерея
дочь: дочь
шабанова: шабанова
открывать: открывать
являться: является
отменять: отменить
самостоятельно: самостоятельно
принимать: принять
путь: путь
место: месте
психотерапия: психотерапия
правильно: правильно
подход: подход
начинать: начала
окружающий: окружающий
самообслуживание: самообслуживанию
член: члена
поддержание: поддержание
кварцевание: кварцевание
повар: поваром
контакт: контакты
профессиональный: профессиональные
generatepress: generatepress
привычный: привычную
способность: способности
такой: таких
усовершенствовать: усовершенствует
домашний: домашних
расти: рос
возврат: возврат
зарядка: зарядка
район: района
доступный: доступный
словарный: словарного
социум: социум
далеко: далеко
дарья: дарья
дома: дома
неделя: неделя
мини: мини
здоровый: здоровый
приготавливать: приготовлена
гибкий: гибкий
другой: другое других
отмечать: отмечаем
внимание: внимания
метр: метрах
становиться: становиться
отправка: отправки
предоставлять: предоставляет
понимать: понимает
любой: любом
системный: системная
мир: мир
гарантия: гарантия
дзержинский: дзержинского
учет: учетом
самый: самое
сочетать: сочетаем
располагать: расположенный
предлагать: предлагаем
необходимо: необходимо
нужно: нужно
правильный: правильном
характер: характера
обретать: обрести
чтение: чтение
сбалансированный: сбалансированное
дошкольник: дошкольника
помощь: помощь
горшок: горшок
папа: папа
раскрываться: раскрыться
отличие: отличие
p: p
практически: практически
