книга: книга
свежий: свежие
пирог: пирог
колумбия: колумбии
корсо: корсо
горох: горохом
горный: горных
ужасный: ужасные
вино: вина вино
ограбление: ограбление
соус: соусы соусом
возрождать: возрождают
подсаживать: подсаженные
суп: суп
каша: каша
кислый: кислых
полк: полка
миллисекунда: миллисекундах
внутри: внутри
семга: семга
кухня: кухне кухня
новогодний: новогодние
факт: фактов
закуска: закуски
сырный: сырный сырная
новый: новый
испания: испании
свекла: свеклой
шампиньон: шампиньоны
программа: программе
чилийский: чилийские чилийский
любимый: любимая
думать: думай
замораживать: замороженная
внук: внуками
перепелиный: перепелиными
век: века
салат: салат салаты
огонь: огня
батат: бататах
вкус: вкус вкуса
рожать: рождена
тортильи: тортильи
год: года год лет
порт: порту
книжный: книжная
видео: видео
одиночество: одиночества
вешенка: вешенками
лицо: лицо
похлебка: похлебок
революция: революция
филипп: филиппом
путешествие: путешествие путешествия
пшеница: пшеницы
аргентинский: аргентинская
фетишизм: фетишизм
галина: галина
арбузный: арбузная
яйцо: яйцами
пепэн: пепэна
рим: рим
шницель: шницель
чихиртма: чихиртма
странный: странный
гречневый: гречневая
стир: стир
moine: moine
тарелка: тарелка
коктейль: коктейль
зеленый: зеленой
тв: тв
исторический: исторических
пирс: пирс
повар: повар
комментарий: комментарии
рецепт: рецепты рецепт
масляный: масляное
анна: анна
дань: даней
шкварка: шкварки шкварками
совершать: совершено
аромат: ароматы
паста: паста
идея: идеи
грейпфрут: грейпфрут
плотник: плотник
лосось: лосося
история: истории историей
напиток: напитки
запекать: запеченными
дома: дома
simple: simple
полба: полбой
выходить: выходя
сентиментальный: сентиментальное
месяц: месяца
свинина: свининой
баклажан: баклажана
vosges: vosges
бешамель: бешамель
фалафель: фалафель
фрайя: фрай
фасоль: фасоли
смалец: смалец
моника: моники
святой: святому
куриный: куриными куриные
мисо: мисо
свысока: свысока
санта: санта
москва: москву
урок: уроки
универсальный: универсальная
кухонный: кухонный
полезный: полезное
кулинарный: кулинарная
кунжутный: кунжутных
сильно: сильнее
карамелизировать: карамелизированной
de: de
второй: вторые
вок: вок
жареный: жареными
te: te
искусство: искусство
запись: записи
щи: щей
чечевица: чечевицы
гороховый: гороховый
монах: монаха
жак: жака
табула: табуле
турецкий: турецким
венский: венский
блог: блоге
завтрак: завтраки
муцарелл: муцарелла
семечко: семечек
сербский: сербский
слайсер: слайсер
готовить: готовим
гриб: грибами
начос: начос
любопытный: любопытных
пять: пять
мой: моими
давид: давиде
шефский: шефская
совет: советов
земля: земли
неожиданный: неожиданных
омлет: омлетов омлет
ирина: ирина
вкусный: вкусные
канал: канале
quick: quick
заправка: заправка
изобретение: изобретения
десерт: десерты
винный: винное
меню: меню
китайский: китайский китайских
секрет: секретов
яблоко: яблоками
сделать: сделай
севич: севиче
ризотто: ризотто
кудри: кудри
отель: отелей
часть: часть
масло: масло
фастфуд: фастфуд
швейцарский: швейцарского
ночной: ночной
счастливый: счастливых
выпечка: выпечка
кукурузный: кукурузные
блюдо: блюд блюда
вьетнамский: вьетнамский
montangard: montangard
помощь: помощь
время: времена
морковь: морковью
перловка: перловки
кускус: кускус
маргарита: маргарита
макдоналдс: макдоналдса
тыква: тыкве тыквой
обзор: обзоры
датский: датский
кофе: кофе
главный: главных
изобретать: изобрел
домашние: домашние
лайфхак: лайфхак
край: края
валентин: валентину
фаршированный: фаршированные
шеф: шефа
кремчиз: кремчиз
бакланова: бакланова
помидор: помидорами
луг: лугов
ольга: ольга
топ: топ
