модификация: модификация
соответствовать: соответствует
собственный: собственное
плотность: плотности
цена: цену
подробно: подробнее
e: e
dimond: dimond
компания: компании компания
mail: mail
декабрь: декабря
полный: полного полное полная
иметь: имеет
карта: карта
любой: любым любой любых
главный: главная
волюметр: волюметра
прибор: приборов
pharma: pharma
растворимость: растворимость растворимости
заниматься: занимается занимающееся
статья: статей статьи
требование: требования требованиям
интерес: интерес
новый: новую новая
почта: почта
инструмент: инструменты инструмента инструмент
таблеточный: таблеточные таблеточных
различный: различными различных
анализ: анализа
регион: регионов
техника: техники
надежность: надежность
отрасль: отрасль
измерение: измерения
позволять: позволяет
простой: простейшего
появляться: появляться
такой: таких такие
usp: usp
угол: угла
выбор: выбор выбора
марк: марку
привод: привода привод
мазь: мазей
испытание: испытаний
заказчик: заказчика
прочность: прочности
классический: классического
лаборатория: лабораторий
система: система системы
особенность: особенности
методика: методикам
производство: производстве производств производства производство
вращение: вращения
вводить: введите
info: info
спектр: спектр
мягкий: мягких
редуктор: редуктора
удобство: удобство
суппозиторий: суппозиториев
цикл: цикла цикл
пилотный: пилотные пилотных
сложный: сложным
возможный: возможна
распадаемость: распадаемости распадаемость
анонсировать: анонсируем
определение: определения
линейка: линейка линейке линейки
полностью: полностью
европейский: европейской
тестирование: тестирования
помимо: помимо
высокий: высокие высокая
принадлежность: принадлежностей
лекарственный: лекарственных
квалификация: квалификации
регулировка: регулировка
обслуживание: обслуживании
память: памяти
наш: нашим нашего наша
помощь: помощью
стр: стр
новое: нового
программа: программ
стандартный: стандартного
стоимость: стоимости
польский: польской
предприятие: предприятий
россия: россии
пресс: пресс прессов
добро: добро
аналитический: аналитическим
насадка: насадок насадками
скотт: скотта
предлагать: предложить предлагаем
пресса: прессы пресса
модульный: модульных
таблетка: таблетки таблеток
капсула: капсулы капсул
отдельный: отдельную
клиент: клиентам
задача: задачам задачу
сменный: сменных
сервис: сервис
эксплуатация: эксплуатацию эксплуатации
www: www
предъявлять: предъявляющая
оборудование: оборудованием оборудование оборудования оборудованию
установка: установки установок
фармацевтический: фармацевтических
истираемость: истираемость
твердый: твердых
pharmag: pharmag
оптимальный: оптимальное
другой: другие других
мелкосерийный: мелкосерийных мелкосерийное
автоматизация: автоматизация
г: г
эксклюзивный: эксклюзивного
эргономичность: эргономичность
телефон: телефоны телефон
факс: факс
материал: материалов
автоматический: автоматические автоматической
производитель: производителей производителя
средство: средств
вид: виды
многоканальный: многоканальный
производственный: производственного производственных производственному
научно: научно
уважаемый: уважаемые
приобретать: приобретенной
форма: формы форм
жидкость: жидкостей
проводить: проводить
российский: российской российский
полуавтоматический: полуавтоматические
фармакопея: фармакопеи фармакопеям
самый: самый
малотоннажный: малотоннажного
рад: рада рады
test: test
farmalabor: farmalabor
подразделение: подразделение
тип: типами
металл: металлов
организация: организации организация
стандарт: стандарты
riva: riva
лабораторный: лабораторному лабораторным лабораторного
посвящать: посвященный посвященные
выпускать: выпускаемое
like: like
решение: решение
центр: центра
ru: ru
возможность: возможность
порошок: порошков
ваш: вашему
смеситель: смесителей
повышенный: повышенный
ион: ионов
сайт: сайта сайт сайте
индивидуальный: индивидуальный
pharmatest: pharmatest
американский: американской
покрытие: покрытий
электронный: электронная
специалист: специалисты специалистов
драже: драже
ep: ep
ручной: ручные
узнавать: узнайте
твердость: твердость
проходить: прошел
adamus: adamus
вспомогательный: вспомогательные
этап: этапе этапам
насыпной: насыпной
каждый: каждой
напыление: напыление
клик: клик
промышленный: промышленных
год: годы года
оснащение: оснащения
ампула: ампул
символ: символы
разработка: разработки
хрупкость: хрупкости
бесплатный: бесплатный
товар: товар
скорость: скорости скорость
сообщение: сообщение
новость: новости
желатиновый: желатиновых
опыт: опыт
политика: политика
д: д
тестер: тестеры
продукция: продукции
рисунок: рисунком
час: час
последний: последние
технологический: технологических
сопутствующий: сопутствующего
специализированный: специализированного специализированных
картинка: картинки
поддержка: поддержку
ко: ко
откос: откоса
исследовательский: исследовательских
контроль: контроля
параметр: параметров
ряд: ряд
гф: гф
вопрос: вопрос вопросам
универсальный: универсальный
совмещать: совместим
pvd: pvd
растворение: растворение растворения
соответствие: соответствие
рубрика: рубрику
коллега: коллеги
препарат: препаратов
возможно: возможно
дозировать: дозирующих
семинар: семинар
практический: практический
подход: подход подхода
отмечаться: отмечается
изготовление: изготовление
тренд: тренд
научный: научный
аргентина: аргентина
заполнение: заполнения
уникальный: уникальных
лс: лс
задавать: задать
гранула: гранул
естественный: естественного
требовать: требуют
моделирование: моделирования
мина: мин
ага: аг
свойство: свойств
информация: информация
процесс: процессов
конкретный: конкретную
метод: методам
выпуск: выпуском
apparatebau: apparatebau
сохранение: сохранение
аналитэксперт: аналитэксперт
качество: качества качеству
двухслойный: двухслойных
упрочнять: упрочняющих
контакт: контакты
весь: весь
carbon: carbon
подбор: подбор
сыпучесть: сыпучести
аргентинский: аргентинская
пр: пр
oq: oq
мельница: мельниц
москва: москва москве
включать: включает
фармакопейный: фармакопейным
прочий: прочих
широкий: широкий
все: всем
создание: созданию
ввод: ввода
analytexpert: analytexpert
рабочий: рабочих
модельный: модельный
торговый: торговую
company: company
фланец: фланец
упаковка: упаковки
обновлять: обновленный
конфиденциальность: конфиденциальности
ведущий: ведущего
находить: найти
модель: моделей
аксессуар: аксессуаров
оказывать: оказать
внимание: вниманию
звонок: звонок
iq: iq
xiii: xiii
гранулятор: грануляторов
ранее: ранее
фио: фио
фарминдустрия: фарминдустрии
большой: большой
особый: особого
проезд: проезд
сопровождение: сопровождении
представлять: представить
быть: будут
устройство: устройств
ориентированный: ориентированных
эксцентриковый: эксцентрикового
германия: германии
специфический: специфические
развитие: развитие
пожаловать: пожаловать
ag: ag
производительность: производительностью
тест: тесты
