доход: доход
чистый: чистом чистый
кодинг: кодинг
лишь: лишь
жизнь: жизни
интернет: интернета интернетом интернет
chatgpt: chatgpt
возникать: возникнут
обратный: обратного
алкаш: алкаши
включая: включая
писать: пишу
профиль: профилей
профессиональный: профессиональную
exact: exact
проблема: проблем проблемы
браузер: браузеров браузере
искусственный: искусственный
монетизация: монетизации монетизация
взгляд: взгляд
существовать: существовали
match: matches
реанимация: реанимации
интеллект: интеллект
сайт: сайт сайтов сайты сайта
плагин: плагинов
типичный: типичный типичного
выходить: выходить
увлекаться: увлекаюсь
категория: категориях
связь: связи
создание: созданием
доска: досках
сервис: сервисы сервис
домохозяйка: домохозяйки
круг: круг
generic: generic
год: года
ваш: ваши ваш
сеть: сети
комментировать: комментировать
tool: tools
прогон: прогон
оживать: оживут
мочь: могу
web: web
мертвый: мертвых мертвые
enter: enter
перезванивать: перезвонить
post: post
скитаться: скитаюсь
украина: украины
инструмент: инструменты
содержимый: содержимому
html: html
непробиваемый: непробиваемы
скобль: скоблей
любой: любых
продвигать: продвинутые
читать: читают
поддержка: поддержка
код: код
скорый: скорая
услуга: услуги
граватар: граватар
бот: ботов
расширение: расширений
искать: искать ищите
реквизит: реквизиты
секунда: секунд
zenfone: zenfone
делать: делаю
многочисленный: многочисленные
технический: технических
дешевый: дешевые
опыт: опыт
быстрый: быстрые
маркетолог: маркетологи
j: js
selector: selectors
page: page
забывать: забудьте
нетребовательный: нетребовательных
поэтому: поэтому
лечение: лечение
рамка: рамки
пресс: пресс
продукт: продукты
общепринятый: общепринятого
spam: spam
блокиратор: блокиратор
вирус: вирусов
размышление: размышления
эволюция: эволюцию
gravatarus: gravatarus
случай: случаях
экран: экранов
борода: бородой
легкое: легкие
интернетчик: интернетчик интернетчика
консультация: консультации
отличный: отличная
excerpt: excerpt
безопасность: безопасности
задача: задач
сингулярность: сингулярности
авторский: авторской
самый: самое самый самых
смартфон: смартфонов
написание: написание написания
уметь: умею
seo: seo
badbot: badbot
программист: программисты
готовый: готовые
php: php
вс: вс
каталог: каталог
социометр: социометр
заставлять: заставить
фантазия: фантазией
рассчитывать: рассчитывать
ряд: ряд
мастер: мастера
размещение: размещение
затрагивать: затрагиваемых
инфопродукт: инфопродуктов
креативный: креативные
виджет: виджет
type: type
оптимизатор: оптимизаторы
заказчик: заказчик
wordpress: wordpress
информационный: информационной
творчество: творчестве
file: files
универсальный: универсальный
сайтостроение: сайтостроения
безнадежный: безнадежных
hidden: hidden
эксклюзивный: эксклюзивно эксклюзивных
title: title
метод: методов
решение: решение
лайков: лайков
переходить: перейти
wp: wp
появление: появления
ссылаться: ссылаться
материя: материи
верифицировать: верифицировано
первичность: первичности
ссылка: ссылки
звонок: звонка
сделать: сделать
распространение: распространение
большой: большой
content: content
анализатор: анализаторами
landing: landing
фриланс: фриланса
иммиджмейкер: иммиджмейкеры
технологический: технологической
больной: больной
помощь: помощь
полезный: полезен
дилетант: дилетанта
коллекция: коллекция
расшифровывать: расшифровать
автор: автора
веб: веб
проект: проекты
визитка: визитки
область: области
эволюционировать: эволюционировал
последний: последнее
начинающий: начинающие
дух: духа
релиз: релизов
решать: решаю
ака: ака
практичный: практичный
search: search
объявление: объявлений
вопрос: вопросы
вячеслав: вячеслав
оптимизация: оптимизация
продвижение: продвижения
белый: белых
блог: блог
нажимать: нажмите
который: которые
подсчет: подсчета
ограничивать: ограничен
работа: работы
товар: товары
