коммуникация: коммуникациях коммуникации коммуникаций
стратегический: стратегическое
cup: cup
ваш: вашего вашем вашу
построить: построила
карточка: карточки
появляться: появился
неочевидный: неочевидная
пользователь: пользователь пользователи
определять: определят
video: video
почтовый: почтовый почтовом
компания: компаний компании компания
добавлять: добавить
спонсорский: спонсорскими
знать: знаете знать
использовать: используйте использовать используя
социальный: социальных социальная
рассылка: рассылку рассылка
продвигаться: продвигаться
молодой: младше
декабрь: декабря
результат: результат
карта: карта картам
принятие: принятии
интерьер: интерьеров
crm: crm
нейросеть: нейросети
зарегистрировать: зарегистрировано зарегистрировать зарегистрированы
clean: clean
seonews: seonews
виртуальный: виртуальных
иголка: иголку
статья: статья статей статьи
выбирать: выбирать
решение: решений решения
леонидович: леонидович
настройка: настроек настройка
ecommerce: ecommerce
принадлежать: принадлежат
вчера: вчера
маркетолог: маркетолога маркетолог
r: rss r
инструмент: инструменты инструментов
эл: эл
старый: старым
стратегия: стратегий стратегию стратегия
самый: самая самой
эфир: эфир
аккаунт: аккаунт аккаунтов
продажа: продажа продаж
стоять: стоит
winprogs: winprogs
официальный: официальный
сотрудник: сотрудников
латинский: латинской
различие: различия
трекинг: трекингу
реклама: рекламу реклама
очень: очень
гипотеза: гипотез
история: историей
публикация: публикации
режим: режиме
проверять: проверьте
условие: условия условиях
день: день дней
риск: риска
рейтинг: рейтинг рейтинги рейтинга
ребенок: детей
удержание: удержания
отсутствие: отсутствии
обнаружение: обнаружения
бюджет: бюджет бюджета
денис: денис
эффективность: эффективности
получать: получить получать
pbn: pbn
выбор: выбор
safronova: safronova
развитие: развития
хотеть: хочу хочет
система: система системы
особенность: особенности
mini: mini
март: марта
ссылка: ссылки ссылка ссылками
защищать: защищены
ozon: ozon
отправлять: отправьте
mba: mba
вводить: введите ввел вводит
стартапа: стартапами
info: info
каталог: каталог каталоги каталоге
соцсеть: соцсети
реализация: реализации
почитать: почту
идти: идти
искать: ищем
интернет: интернете интернет
мобильный: мобильная
явно: явно
сеть: сеть сетей сетях
мочь: могу могут можете
опасность: опасности
agima: agima
art: art
обращать: обратили
executive: executive
сомнительный: сомнительный
платформа: платформы платформу платформа
бизнес: бизнесе бизнеса бизнес
email: email
сафронова: сафронова
владелец: владельцев
сегодня: сегодня
сила: сила
приглашать: приглашаем
protected: protected
сливать: слить
вечнозеленый: вечнозеленый
объединять: объединит
объявлять: объявил
делать: делать
проект: проектов проекте проектами
клиент: клиентам клиентов
который: которых которой которые
сегмент: сегменте
удерживать: удерживать
прямой: прямая прямой
популярный: популярным популярных популярное популярные
запрещать: запретил
телекоммуникационный: телекоммуникационных
лидер: лидеров
квартира: квартиры
challenge: challenge
право: права
девятка: девятки
продвижение: продвижения продвижение
внимание: внимание
оперативный: оперативного
игрок: игроков
поддержка: поддержкой
топ: топе топ
шакин: шакин
россия: россии
безопасный: безопасную
mytracker: mytracker
внесение: внесение
товар: товарах
агентство: агентств агентство
связь: связь связи
gmail: gmail
быстро: быстро
выдача: выдаче выдачи выдача
поисковый: поисковый поисковые
счет: счету
отличие: отличий
twitter: twitter
воронка: воронки
аналитика: аналитика
эффективный: эффективных эффективной
тема: темы
рекламный: рекламную рекламным рекламных
алгоритм: алгоритмы алгоритм
издание: издание
александр: александр
сео: сео
выгодный: выгодная
www: www
расчет: расчетах
создавать: создать
вирусный: вирусный
профессия: профессии профессия
глобальный: глобальных
канал: каналы канал
миф: мифа
супер: супер
отзыв: отзыв отзывов отзывы
site: site
рекламодатель: рекламодателям
такой: такое
бесплатный: бесплатной
сми: сми
контент: контент
техника: технику
подтвердить: подтвердите
другой: другие других
marketing: marketing
трафик: трафика трафик
превышать: превышено
г: г
мировой: мировой
day: day
победитель: победителей
определяться: определился
worldwide: worldwide
отвечать: отвечаем
frontend: frontend
метрика: метрику
служба: службой
разработка: разработка
технология: технологий
почта: почтой почте
дизайн: дизайну
вид: виды
кто: кому
novofon: novofon
vkontakte: vkontakte
apply: apply
классический: классический
затрагивать: затронет
маркетинг: маркетинг маркетингом маркетинга
набор: набор
практика: практика
продвигать: продвигать
парсинг: парсинг
детский: детскую
конференция: конференции
ооочень: ооочень
становиться: становится
опасный: опасны
месяц: месяц
михаил: михаил
привлекать: привлекать
ingate: ingate
вс: вс
алена: алена
тот: тех
подкаста: подкаст
ока: ок
простой: простыми
вызов: вызовов
полезный: полезны
социалка: социалки
обучение: обучения
ценник: ценнике
понимать: понять
единица: единица
вставлять: вставить
рабочий: рабочие
восток: востоком
облачный: облачных
недвижимость: недвижимости
нативный: нативная
стартовать: стартовал
ru: ru
большой: большому
вэд: вэд
digital: digital
force: force
платный: платной
книга: книг
сайт: сайт сайтов сайта сайте сайты
яндекс: яндекс яндекса
сено: сена
microsoft: microsoft
ооо: ооо
texterra: texterra
сей: сих
совет: советы
телефон: телефон
назад: назад
январь: января
кабинет: кабинетом
специалист: специалистов
развивать: развивать
партнер: партнеры
офис: офисы
прием: приемы
кейс: кейса кейсов кейс
оптимизация: оптимизация
forum: forum
pr: pr
светлана: светлана
ольга: ольга
получаться: получившийся
известность: известности
опыт: опыта
pitch: pitch
ресторан: ресторана
грамотный: грамотной
сервис: сервисы сервисов
число: число
локальный: локальный
находить: нашли найти
автор: авторов
бэкенд: бэкенд
отличаться: отличается
неделя: неделю недели
бренд: бренда
руководитель: руководителей руководитель
массовый: массовых
технический: технические
скопировать: скопировать
мешать: мешающих
год: году года лет
хм: хм
линия: линия
ключевой: ключевых
список: список
отечественный: отечественного
одноклассник: одноклассники
главное: главное
новый: новых
куба: кубе
составлять: составить
margo: margo
предстоящий: предстоящие
выход: выхода
библиотека: библиотека
рассказывать: рассказываем
развлечение: развлечений
персонализация: персонализация
редакция: редакции
low: low
событие: событий события
создание: создание создания
специ: специ
апдейт: апдейт
вход: входа
backend: backend
одобрять: одобрено
новость: новости
vproc: vproc
федеральный: федеральной
функция: функций
летний: летней
раздел: разделы
прибыль: прибыль
талант: таланты
запись: запись
com: com
предыдущий: предыдущие
работа: работы работе
tandem: tandem
пресс: пресс
ex: ex
ящик: ящик ящике
правило: правила
час: час
мероприятие: мероприятия
февральский: февральский
собственник: собственнику
учетный: учетную
монтаж: монтажа
главный: главный
статистика: статистика
adwords: adwords
лидерство: лидерство
глоссарий: глоссарий
прощаться: прощаемся
юзабилити: юзабилити
code: code
алексей: алексей
вконтакте: вконтакте
стартап: стартапа
шинкаренко: шинкаренко
учиться: учиться
group: group
контекстный: контекстная
skillfactory: skillfactory
америка: америкой
изобретать: изобрела
contented: contented
дроп: дропы
seo: seo
micro: micro
слово: словами
владимир: владимир
c: c
омниканальность: омниканальность
ряд: ряд
сфера: сфере
недооценивать: недооцененная
вообще: вообще
два: две
ломовский: ломовской
лет: летов
каждый: каждую
управление: управление управления
этот: этих
сетевой: сетевое
универсальный: универсальный
term: terms
google: google
регистрация: регистрации регистрация
савельев: савельев
интервью: интервью
yahoo: yahoo
давать: даст
подписываться: подписаться подписывайтесь
вебмастер: вебмастерам
профиль: профиля профилей
оценка: оценки
перспектива: перспектива
кодирование: кодирования
родитель: родители
единый: единую
нацеливать: нацелить
фронтенд: фронтенд
магазин: магазин
реестр: реестр
показатель: показателей
долго: долго
построение: построения
тwitter: тwitter
renaissance: renaissance
recaptcha: recaptcha
ближний: ближним
персонал: персонала
выходить: выходим
стог: стоге
оптималь: оптималь
достижение: достижения
вопрос: вопросы
ctrl: ctrl
store: store
возможность: возможности
антикризисный: антикризисные
привлечение: привлечения
разбор: разбор
крупный: крупнейших
помнить: помнить
фишка: фишки
блог: блога блоги
русскоязычный: русскоязычные
new: new
chatgpt: chatgpt
писать: писать
объявление: объявление
влиять: влияет
work: works
сервер: сервера
принимать: принять
fmcg: fmcg
подход: подход
редактор: редактор
вокруг: вокруг
новичок: новичку
угроза: угроза
подтверждение: подтверждение
африка: африкой
ошибка: ошибка ошибок
исследование: исследования
тренд: тренды
ради: ради
контакт: контакты
telegram: telegram
эксперт: эксперт экспертами
retail: retail
vk: vk
работать: работает работать
место: мест
enter: enter
шаблон: шаблон
продавать: продают
sm: sms
medium: media
код: код
бот: ботов
грозить: грозят
оформлять: оформлять
privacy: privacy
ограничение: ограничений
ad: ads
gr: gr
версия: версия
маркетинговый: маркетинговых
один: одном
отрасль: отрасли
original: original
обращение: обращений
policy: policy
штат: штат
подтверждать: подтвердить
февраль: февраля
ежегодный: ежегодный
аренда: аренда
запускать: запустил
штатный: штатная
спасибо: спасибо
маркетплейс: маркетплейсы
неопределенность: неопределенности
энциклопедия: энциклопедия
разбираться: разберемся
пригождаться: пригодятся
роман: роман
будущее: будущем
романенков: романенков
пора: пор
рынок: рынка
pinterest: pinterest
proxy: proxy
финтех: финтех
hr: hr
обновление: обновление
ещ: ещ
service: service
релиз: релизы
фс: фс
октябрь: октября
информационный: информационных
рунет: рунет
поиск: поиск
свидетельство: свидетельство
эксперимент: эксперимент
виджет: виджет
гость: гость
длинный: длинный
связываться: свяжитесь
продукт: продуктов
глаз: глазами
нужно: нужно
ручной: ручном
ашманов: ашманов
чилаут: чилаут
входить: войти
запрос: запрос
период: период
продуктивный: продуктивных
io: ios
госуслуга: госуслугах
trade: trade
личный: личного
малый: малого
база: базе
забирать: забрать
цель: целей
performance: performance
zadarma: zadarma
нанимать: нанимать
вовремя: вовремя
ньюз: ньюз
программист: программиста
корпоративный: корпоративного
разработчик: разработчиков
прокси: прокси
facebook: facebook
вордс: вордс
экспортный: экспортный
календарь: календарь
опечатка: опечатку
устройство: устройств
accsmarket: accsmarket
директ: директ
пример: примеры
учредитель: учредитель
тактика: тактика
b: b
надзор: надзору
антименеджмент: антименеджмент
