академик: академика
купон: купоны купонов купона купон
аромамассаж: аромамассаж
сауна: сауны сауна
подробно: подробнее
палочка: палочками
mysaanluzri: mysaanluzri
компания: компании
специалист: специалист
салон: салон салонах салоне
включать: включено
дом: дом
комплекс: комплексе комплекса комплекс
пилинг: пилинг
отправлять: отправлено отправлять
социальный: социальных
близкий: ближайшие
аксессуар: аксессуары
номер: номере
бочка: бочке
подписываться: подпишись подписаться подпишитесь
мусс: мусс
долгопрудный: долгопрудный
доплата: доплата
область: область
kid: kids
салонеspa: салонеspa
развлечение: развлечений развлечения развлечениями
зарегистрироваться: зарегистрироваться
т: т
пол: пол
полет: полет полета
омоложение: омоложение
массажный: массажный
новый: новый новая
уведомление: уведомления
ремонт: ремонт
lisakupon: lisakupon
имидж: имидж
система: систем системе
аккаунт: аккаунта
арганов: аргановым
баня: баня
клуб: клубе клуб
чистка: чистка
дзержинский: дзержинский
рассылка: рассылку рассылки
фэнтази: фэнтази
высылать: выслать
бассейн: бассейном бассейна бассейн
ребенок: детей ребенка детям
банный: банном банного
римский: римской
распаривание: распаривание распариванием
гостиница: гостиницы
фомин: фомин
чеховский: чеховский
выбор: выбор
медовый: медово
доплачивать: доплатите
аквапарк: аквапарки аквапарках аквапарке аквапарка аквапарк
запись: записи
info: info
обувь: обувь
р: р
почитать: почту
покупка: покупку покупки
лимфодренажный: лимфодренажный
сбермаркет: сбермаркет
ko: kos
самый: самые
реутов: реутов
kingcoupon: kingcoupon
стиль: стиль
одежда: одежды одежда
санаторный: санаторная
сотрудничество: сотрудничество
отдых: отдыха отдых
email: email
час: часа
kuponator: kuponator
посад: посад
аэропорт: аэропорт
инстаграм: инстаграм
ролл: роллов
находить: найдено
соглашение: соглашение
массаж: массажа массаж
выгодный: выгодные
скидка: скидкой скидку скидок скидка скидки
право: право
павловский: павловский
красногорск: красногорск
ходынский: ходынский
проект: проекте
спорт: спорта спорт
процедура: процедуры
здоровье: здоровье
китайский: китайский
улица: улица
локомотив: локомотив
ваш: ваш
дельта: дельта
хотеть: хочу
колесо: колес
предварительный: предварительный
фитнес: фитнес
сменить: сменить
цветок: цветы
купибонус: купибонус
форма: форму
мобильный: мобильного
игра: игра игры
зарегистрировать: зарегистрированы
qwmzwtpyifkkjw: qwmzwtpyifkkjw
park: park
подмосковье: подмосковье подмосковья
начислять: начислим начислить
хобби: хобби
домодедово: домодедово
старый: старый
spa: spa
экскурсия: экскурсия
будни: будни
питание: питанием
раздел: раздел разделе
солнечногорск: солнечногорск
авторизоваться: авторизуясь
измайловский: измайловское
красота: красоты красота
суша: суши
руб: руб
ссылка: ссылкой
установленный: установлен
человек: человек
предложение: предложения
отель: отель отеле
сертификат: сертификат
популярный: популярное
обертывание: обертывание обертыванием
сми: сми
данный: данных
другой: другие другими
девичник: девичник
г: г
обучение: обучение
доставка: доставкой доставка
кухня: кухни
партнер: партнера
выбирать: выберите
химки: химки
вид: виды
сувенир: сувениры
боулинг: боулинга боулинг
получать: получишь
ночь: ночи
театр: театр
грузинский: грузинской
тонизирующий: тонизирующий
любой: любой
персональный: персональных
классический: классический
мастер: мастер
сеанс: сеансов
константиновский: константиновское
рядом: рядом
детокс: детокс
марокканский: марокканский
test: test
thai: thai
братиславский: братиславская
планета: планета
м: м
командный: командный
обслуживание: обслуживание
организация: организация
подольск: подольск
тело: тела телом
студия: студии
служба: служба
промокод: промокодов
спа: спа
звенигород: звенигород
автомойка: автомойка
fly: fly
коррекция: коррекции
вместо: вместо
ароматерапия: ароматерапия
конкурс: конкурсах
переходить: перейти
картинг: картинг
тайский: тайский
анимация: анимацией
креольский: креольский
ru: ru
ч: ч
cashback: cashback
душ: душ
денежниковый: денежниково
уход: уход
купонатор: купонатор
аннино: аннино
путешествие: путешествия
restoraids: restoraids
акция: акций акции акция
такой: таким
балашиха: балашиха
телефон: телефон
фотосессия: фотосессия
наличие: наличии
поселение: поселение
экстрим: экстрим
шоссе: шоссе
переход: переход
блюдо: блюда
георгий: георгий
foodkupoon: foodkupoon
антицеллюлитный: антицеллюлитный
лыткарино: лыткарино
кэшбэк: кэшбэка кэшбэк
тибетский: тибетский
использование: использования
индийский: индийский
иначе: иначе
обследование: обследование
белье: белье
прикосновение: прикосновение
бар: бар
ингаляция: ингаляцией
эвкалипт: эвкалипт
посещение: посещение посещением
загородный: загородный загородном
кедровый: кедровой
лифтинг: лифтинг
неделя: недели
день: день дня
попробовать: попробовать
тной: тной
login: login
база: база
город: город
мята: мята
пос: пос
сайт: сайт сайты сайте
лотос: лотоса
аэродинамический: аэродинамический
релакс: релакс
катание: катания
интересный: интересные
посмотреть: посмотреть
программа: программа программы
браузер: браузере
r: r
еда: еды еда
днепропетровский: днепропетровская
культурный: культурные
оплата: оплата
услуга: услуги
вход: вход входа
фигура: фигуры
прочий: прочие
одинцово: одинцово
д: д
чехов: чехов
рисование: рисование
мрт: мрт
безоперационный: безоперационные
шатура: шатура
лечение: лечение
выходной: выходные
уч: уч
вернуть: вернуть
гидромассаж: гидромассаж
южный: южная
мероприятие: мероприятия
пражский: пражская
лок: лок
прохорово: прохорово
диагностика: диагностика
снижение: снижение
класс: класс
boombate: boombate
деревня: деревня
беговой: беговая
клин: клин
бульвар: бульвар
музей: музей
забывать: забыли
пушкино: пушкино
стандарт: стандарт
пицца: пиццы
профилактика: профилактика
образование: образование
c: c
пароль: пароля пароль
метро: метро
foresta: foresta
обработка: обработку
сельский: сельское
пн: пн
раменский: раменский
ценный: ценные
размещать: разместить
оздоровительный: оздоровительная
люблинский: люблинская
регистрация: регистрация
вакансия: вакансии
ступино: ступино
сеть: сетях
см: см
time: time
жуковский: жуковский
творческий: творческое
приз: призы
часть: часть
электросталь: электросталь
продолжать: продолжить
деньги: деньги
обновление: обновления
курсы: курсы
tao: tao
парк: парк
письмо: письмо
text: text
точечный: точечный
солевой: солевой
пихта: пихта
start: start
восстановление: восстановление
биглион: биглион
испанский: испанский
активный: активный
санаторий: санатории
лицо: лицом
тц: тц
мара: мар
традиционный: традиционный
янгель: янгеля
инструктаж: инструктаж
квест: квест
маска: маска
район: район
место: месте
масляный: масляный
заведение: заведения
festival: festival
московский: московская
хороший: хорош
анонимный: анонимный
кафе: кафе
измайлово: измайлово
перечислять: перечислять
масло: маслом
раменское: раменское
восточный: восточный
прочее: прочее
показывать: показать
контакт: контакты
зуб: зубов
telegram: telegram
global: global
марьино: марьино
категория: категории
тот: те та
диамант: диамант
смотреть: смотреть
ситикупон: ситикупон
партизанский: партизанская
косметология: косметология
отписываться: отписаться
москва: москва москвы москве
развлекательный: развлекательный
тюнинг: тюнинг
опубликовывать: опубликован
бильярд: бильярд
двое: двоих
bot: bot
станция: станция
подарок: подарки
согласие: согласие
авто: авто
февраль: февраля
авиапарк: авиапарк
нежный: нежный
бамбуковый: бамбуковыми
пирогов: пирогов
смена: смена
подарочный: подарочный
аэротруба: аэротрубе
поддержка: поддержки
один: одного
люберцы: люберцы
предоставлять: предоставляет
семейный: семейного
ресторан: ресторан
ещ: ещ
динамо: динамо
карта: карте
праздник: праздники праздника
поиск: поиск
стоматология: стоматология
мытищи: мытищи
целый: целый
входить: войдите войти
вес: веса
условие: условия
пользовательский: пользовательское
анализ: анализы
отзыв: отзыв
минута: минут
короть: корол
выигрывать: выиграешь
шиномонтаж: шиномонтаж
восстанавливать: восстановить
мегакупон: мегакупон
химчистка: химчистка
танец: танцы
центр: центр
зимний: зимний
сразу: сразу
улучшать: улучшенный
развитие: развитие
зеленоград: зеленоград
заработать: заработанный
