фитнес: фитнес
полезный: полезные полезен полезны
зеленый: зеленому зеленый
питание: питание питании
рф: рф
чай: чаю чай
жизнь: жизни жизнь
ожирение: ожирение ожирением
рождение: рождения
беременный: беременные беременной беременных
связь: связь
порок: пороком порок
закон: законов
вес: вес весом
долго: дольше
именно: именно
atis: atis
быть: будете
рассказывать: расскажет
официальный: официальной
беременность: беременности
причина: причиной
гиперссылка: гиперссылки
рисковать: рискуют
ответственность: ответственность
контент: контента контенту
образ: образе образ
карта: карта
главный: главная
общий: общего
сайт: сайт сайта
зож: зож
похудение: похудении похудение
запись: записям
говорить: говорят говорил
позитивный: позитивный
исследование: исследования
здоровый: здоровый здоровом
женщина: женщин
интернет: интернета
противный: противном
свойство: свойства
указание: указанием
распространять: распространять
диабет: диабетом диабет
лишний: лишний лишним
младенческий: младенческой
идея: идея
life: life
становиться: стать
навигация: навигация
случай: случае
другой: другие
весь: вся
мы: нам
медицинский: медицинской
смех: смех
политика: политика
медицина: медицина медицины
смерть: смерти
вероятность: вероятностью
тип: типа
фетальный: фетальной
точка: точки
зрение: зрения
раковый: раковых
цель: целях
рак: рак
материал: материалы
проживать: прожить
регулярно: регулярно
повышенный: повышенных
нарушение: нарушение
каков: какова
помогать: помогают
статья: статьи
вредный: вреден
мнение: мнение
саградянин: саградян
капуста: капусты
поиск: поиск
продлевать: продлевает
берет: берет
относиться: относится
правда: правда
конфиденциальность: конфиденциальности
наш: наш нашего
существовать: существует
потерять: потерять
материнский: материнское
польза: польза пользе
правильный: правильном
отслеживать: отслеживаем
ребенок: ребенка
переходить: перейти
сегодня: сегодня
некоммерческий: некоммерческих
го: го
использование: использование
ru: ru
заболевание: заболеваний
сахарный: сахарный
вред: вред
сердце: сердца
индексировать: индексируемой
альберт: альберт
проект: проекте
брокколи: брокколи
здоровье: здоровье
далее: далее
риск: рисках
нести: нести
простор: просторах
взгляд: взгляд
