россия: россии россия
первичный: первичные
связываться: свяжемся свяжется
иной: иное
скорый: скорейшие
форма: форму
мобильный: мобильного мобильной мобильным мобильные
сортировочный: сортировочным
подробно: подробнее
офис: офис
акция: акции
компания: компании компания
бу: бу
адрес: адрес
получать: получите получили
конусный: конусные
сток: стока
скат: скат
заказ: заказ
промышленный: промышленный
оборудование: оборудованием оборудование
дробилка: дробилки дробилка
вы: вами
ниже: ниже
mccloskey: mccloskey
база: база
карта: карта
персональный: персональное персональных
сервис: сервис
группа: группой
карьерный: карьерная
работа: работы
долгопрудный: долгопрудный
менеджер: менеджеров менеджер
первомайский: первомайская
выполнять: выполненных
год: года
отправлять: отправьте отправить отправляя отправлена
ваш: ваша ваши
вибрационный: вибрационные
срок: сроки
роторный: роторные
бетон: бетона
x: x
показывать: показать
theme: themes
qj: qj
новый: новых
контакт: контакты
наш: наш наши нашей наша
вводить: введено
профессиональный: профессиональные профессиональных
мо: мо
хороший: лучшем лучшие
scatcotheme: scatcotheme
режим: режим
logo: logo
пт: пт
отзыв: отзывы
предложение: предложения предложение
й: й
бетонный: бетонно
дсо: дсо
щековый: щековые щековая
создавать: создана
почта: почта
scat: scat
механик: механики
заполнять: заполните
данный: данных
техника: технику техника
основной: основная основных
г: г
заявка: заявку заявка
svg: svg
летний: летним
новое: новое
новость: новости
опыт: опытом опыт
политика: политика
д: д
дробильный: дробильно
эксплуатация: эксплуатацию
финишный: финишный финишные
согласие: согласие
время: время
различный: различных
конвейер: конвейеры
строительный: строительная
заказывать: заказать заказали
хорошевский: хорошевский
клиент: клиенты
аренда: аренда
практический: практической
спасибо: спасибо
действительно: действительно
последний: последние
барабанный: барабанные
грохот: грохот грохота грохоты
продавать: продано
оставлять: оставить
подбирать: подберем
реализованный: реализованные
задача: задачи
китайский: китайский китайские
сервисный: сервисный
img: img
давать: даю
камень: камня
правильный: правильную
ещ: ещ
пожалуйста: пожалуйста
близкий: ближайшее
вид: виде
защищать: защищены
co: co
кр: кр
обл: обл
смесительный: смесительным
info: info
смазка: смазки
каталог: каталог
зч: зч
присутствовать: присутствующих
иностранный: иностранных
sandvik: sandvik
обработка: обработку
пн: пн
рынок: рынке
конфиденциальность: конфиденциальности
инженер: инженеров
http: https
самый: самые
обратный: обратный
течение: течение
стационарный: стационарные
около: около
подробность: подробности
машина: машины машин
поставщик: поставщиков
наработка: наработкой
команда: командой
сегодня: сегодня
звонок: звонок
wp: wp
минута: минут
другой: другое
ru: ru
сво: сво
гордость: гордость
меню: меню
москва: москва
обширный: обширная
content: content
обращение: обращение
сайт: сайта
ооо: ооо
проезд: проезд
ярославский: ярославская
который: которых
финансирование: финансирование
российский: российском
наличие: наличии
проект: проекты проектов
песок: песка
поставка: поставка
оставаться: остались
запчасть: запчасти
узнавать: узнать
центр: центр
краснодарский: краснодарский
выбирать: выбрать
выгода: выгодой
право: права
щебень: щебня
вопрос: вопросы
корпус: корпус
бренд: брендов
блог: блог
лизинг: лизинг
практически: практически
сертификат: сертификаты
иметь: имеющих
многолетний: многолетний
