нажимать: нажимая
веганы: веганам веганов
love: love
vegetarian: vegetarian
цукат: цукатами
цукини: цукини
появляться: появился
создавать: созданный создать
часть: частью
лицо: лица лиц
формат: формат
шоколадный: шоколадной
набирать: набирает
гид: гид гиды
молодой: младше
декабрь: декабря
веган: вегану веганом
однажды: однажды
вызов: вызов
суп: супы
газета: газета
журавлев: журавлев
протеин: протеином
частота: частота
чистота: чистота
рамка: рамках
опробовать: опробовано
андерсон: андерсон
восполнять: восполнить
прессовать: прессованные
решение: решения
нагрузка: нагрузок
федеральный: федеральным
вчера: вчера
принимать: приняли принять
объявлять: объявлен
отведывать: отведать
хороший: лучшие
новое: новое
стоять: стоит
определенный: определенных
котлетка: котлетки
животноводство: животноводство животноводстве
позволять: позволяет
реклама: рекламу рекламы реклама
история: истории историей история
находить: нашла
условие: условиях
веганский: веганское веганский веганских веганским веганские
группа: группа
население: население
ребенок: детей
мой: моих
росток: ростки
молоко: молока
размадзе: размадзе
отход: отходов
благодаря: благодаря
глобальный: глобальной
материал: материалов материалы
картофель: картофеля
развитие: развития
хотеть: хочу хочет
взрослый: взрослые
праздничный: праздничное
ответственный: ответственного
номер: номера
результат: результате
родной: родного
вырастать: вырастают
колонка: колонки
самый: самое самые
способствовать: способствует
совместно: совместно
пожертвовать: пожертвовал
рисовый: рисовыми
год: году лет года год годом
vitamin: vitamins
хлеб: хлеб
мир: мира мире
сегодня: сегодня
испечь: испечь
гуадалупа: гуадалупе
фермер: фермеров
соглашение: соглашение
проект: проекте
начинка: начинок начинками
эффективный: эффективный
который: которых которую которые который
вегетарианец: вегетарианцами вегетарианцем вегетарианцам
страна: страна
согласие: согласии согласия согласие
популярный: популярные
разный: разное разными
исследование: исследование исследованиям
футбольный: футбольные
заглядывать: заглянуть
ссылка: ссылке
увлажнять: увлажняющий
устойчивый: устойчивого устойчивую
текстиль: текстиля
тема: теме
илья: илья
вьетнам: вьетнаме
продажа: продажи
топ: топ
стол: столу
россия: россии
инициатива: инициативах
игра: игры
новость: новости новостями новость
экологический: экологической
ноябрь: ноября
навсегда: навсегда
хобби: хобби
убитый: убитых
несколько: несколько нескольких
миллион: миллион
газ: газом
ные: ные
салат: салаты
здоровый: здоровым здоровую
разрабатывать: разработала
человек: люди человек
обожать: обожала
такой: такое
сертификат: сертификатом
вечеринка: вечеринке
данный: данных
знать: знаю знала
юля: юля
контент: контент
вскоре: вскоре
поделиться: поделиться
есть: едят
текст: текстом
видеть: видеть
блинчик: блинчики
day: day
society: society
ильдар: ильдар
детеныш: детеныш
суперкоров: суперкоров
innovation: innovation
белый: белой
пить: пью
выбирать: выберите
крупный: крупнейший
planet: planet
разрешать: разрешено
содержать: содержать
приходиться: придется
панголин: панголина
friendly: friendly
все: всеми
сокращение: сокращению
рагозин: рагозин
санкт: санкт
млн: млн
звезда: звезда
персональный: персональных
называть: назвали
восстановление: восстановлению
марковец: марковец
продвигать: продвигать
оказываться: оказаться
музыка: музыке
ночной: ночная
раскритиковывать: раскритиковала
памелы: памелы
тбилиси: тбилиси
проводить: провели
рад: рада
живой: живое
свое: свое
крем: крем
производить: производить
направлять: направленных
панова: панова
директор: директора
вполне: вполне
становиться: стала стали
oaэ: oaэ
правда: правда
мидный: миден
кнопка: кнопку
китай: китае
мука: муки
юар: юар
готовить: готовим
крик: крики
йога: йоги
airbnb: airbnb
подписчик: подписчика
подборка: подборки
использование: использование
ru: ru
убийство: убийстве
апрель: апреля
приходить: пришли
закон: законом
точно: точно
тысяча: тысяч
алекс: алекс
топовый: топовые
healthy: healthy
очищать: очищающей
соучредитель: соучредитель
свинья: свиней
shop: shop
зоопарк: зоопарка
идеальный: идеальный идеальное
назад: назад
январь: января
блюдо: блюда
юность: юности
сергей: сергей
наблюдение: наблюдения
батуми: батуми
приготавливать: приготовил приготовят
б: б
спасать: спасли спасать
козлик: козликов
индийский: индийской
выпускать: выпустил
микроэлемент: микроэлементов
недостаточно: недостаточно
n: n
участие: участие
мюсли: мюсли
это: это
культурный: культурных
поскольку: поскольку
рекордный: рекордные
попробовать: попробовать
земля: землю
свой: своему своей
растительный: растительное растительного
учитель: учителя
вкус: вкусами
сайт: сайт
шаймярдянов: шаймярдянов
перекр: перекр
suffiks: suffiks
калмыков: калмыкова
упасть: упали
сдавать: сдавать
борис: борис
наш: наша
редакция: редакции
biotech: biotech
фз: фз
фотография: фотографиях
животный: животных
организм: организма
политика: политика
рецепт: рецепты
напиток: напитки
небоскра: небоскр
тонко: тонко
активизм: активизму
время: время
нутовый: нутовой
уч: уч
работа: работе
бросать: бросили
катастрофа: катастрофы
гость: гостях
блин: блины блинов
kitchen: kitchen
оборот: обороты
этот: эта
неготовность: неготовность
питание: питание питания
екатерина: екатерина
обвинять: обвинили
пластика: пластика
cooky: cookies
поддержка: поддержку
печение: печенье
великобритания: великобритании
подавать: подал
получаться: получатся
биоволокно: биоволокна
пищевой: пищевых
креативный: креативную
дождаться: дождаться
organic: organic
мясо: мясо мяса
зарабатывать: заработал
обработка: обработку
активист: активисты
движение: движением движение
мастермайнд: мастермайнд
батончик: батончики
самка: самки
способный: способных
браконьер: браконьеров
религиозный: религиозных
четыр: четыр
поощрять: поощрять
момент: момента
поесть: поесть
послушать: послушайте
интервью: интервью
потребление: потребления
разгар: разгаре
дебора: дебора
тр: тр
чувствовать: чувствующих
правительство: правительство
выпечка: выпечка
инструмент: инструмент
смочь: смогут
себ: себ
увлечение: увлечение
будущее: будущего
приводить: привело
ролик: ролики
свободный: свободным
остров: острове
кедр: кедр
зооактивизм: зооактивизма
океан: океан
престол: престолов
ехать: еду
являться: является
банановый: банановый
традиционный: традиционного
акция: акции
пекан: пекан
стка: стке
физический: физических
клетка: клеток клетке
масленичный: масленичная
дерево: деревьев
август: августа
подход: подход
какой: какие
мероприятие: мероприятиях
рассказывать: рассказывает
кафе: кафе
вегянварь: вегянваре
этический: этической
миндаль: миндаль
контакт: контакты
юцык: юцык
саморазвитие: саморазвития
мексика: мексика
пшеница: пшеницы
amsilk: amsilk
орехов: орехов
сам: самими
москва: москве
запрещать: запретила запретить
ознакомляться: ознакомьтесь
комбо: комбо
фейк: фейк
скупать: скупают
кекс: кекс
ограничение: ограничений
беспрецедентный: беспрецедентный
свиной: свиной
первый: первую первые
объединяться: объединились
мозг: мозга
клонировать: клонировали
нехватка: нехватку
рассылка: рассылку
неделя: неделя
собирать: собрал
петербург: петербурге
февраль: февраля
удивительно: удивительно
авторский: авторские
sokito: sokito
один: одного
общество: общество
рынок: рынка
новогодний: новогодний
крошка: крошки
давать: даю
организация: организации
статья: статьи
ещ: ещ
второй: вторые
хлопья: хлопьями
юлия: юлия
стремиться: стремится
октябрь: октября
предназначать: предназначенный
встреча: встреч
кой: коей
вегетарианство: вегетарианство
подписываться: подписаться
brain: brain
подписка: подписка
конфиденциальность: конфиденциальности
крушение: крушении
культура: культуру
соответствие: соответствии
глазурь: глазурью
нужно: нужно
программа: программа
посадка: посадку
счастливый: счастливым
анализ: анализы
оаэ: оаэ
предварительный: предварительного
дайвинг: дайвинг
переход: переходу
рождественский: рождественской
десерт: десерты
деринг: деринг
цель: целей
имя: имя
большой: большой
быть: будут буду
овсянка: овсянка
давид: давид
х: х
бутса: бутсы
последний: последнее
vegan: vegan
скидка: скидки
житель: жители
акула: акулой
смотреть: смотрела
май: мая
елена: елена
языковой: языковых
