соображение: соображений соображениям
гарантия: гарантий гарантии
состояться: состоявшееся состоялась
хотеть: хотите хотели
законодательный: законодательные
кабинет: кабинет кабинету кабинете
участие: участию
товарищество: товарищества
мошенничество: мошенничеством мошенничества
большинство: большинстве большинство
создавать: созданных создаете создавать
иметь: имеющие имеющим имеем имеет имеете иметь имеющими имейте имеющих
рамка: рамках
ответ: ответ
выплачивать: выплачены выплачиваем выплаченной выплаченный выплачивает выплаченную
кой: кое
электронный: электронной электронных электронным электронную электронный электронные
гарантироваться: гарантируется
недобросовестный: недобросовестной
решение: решения
освобождать: освобождаете
входить: входят войти
быстрый: быстрый
возможность: возможностью возможности
халатность: халатность
аккаунт: аккаунте аккаунты аккаунту аккаунт аккаунта
направляться: направляться
гарантировать: гарантируем гарантирует гарантировать гарантирующая
партнер: партнеров партнеры
самый: самая самых
мобильный: мобильный мобильных
лицо: лицу лицам лица лиц лицами лицом
небольшой: небольшой
пассивный: пассивный
менее: менее
очень: очень
предоставлять: предоставляемые предоставленные предоставляем предоставляемым предоставлять предоставляете предоставленной предоставим предоставляя предоставляет предоставляемыми предоставляют
публикация: публикации
графа: графе
цель: целей целью цели целях
материал: материала материалах материал материалы
иной: иной иных иным
поступать: поступает
такой: таким таких такого такие
пользование: пользования пользование пользованию
необходимый: необходимая необходимую необходимые необходимы
получать: получить получив получили получать получайте получите получаю получаете полученной получает
платить: платим
распечатывать: распечатав
клиентский: клиентской
важный: важное важными
безопасность: безопасности безопасность
система: систему система системы систем системе
пожалуйста: пожалуйста
публиковать: публикуем
обратный: обратная обратной
магазин: магазинах магазин магазины магазинов магазинами магазином магазина
множество: множество
совершать: совершил совершает совершена совершите совершать совершаемых
данный: данных данным данном данное данного данная данный данному
деньги: деньги денег деньгами
мочь: могли могут можете можем
договор: договора договор
факт: факт факты
юридический: юридическим юридическая юридических
результат: результатов
авторский: авторском
действовать: действовать
давать: дала дает
уточнение: уточнение уточнения
удовлетворенность: удовлетворенности
соглашение: соглашении соглашению соглашения соглашение
email: email
предлагать: предлагаемых предлагаемые
достаточный: достаточное
изменение: изменениями изменение изменения
переход: переходе
передавать: передавать
данные: данные данными
находить: найдено
кэшбэк: кэшбэки кэшбэка кэшбэк кэшбэком
наш: нашем нашими наших наши нашего наша нашему нашей наш нашу нашим
каждый: каждый каждое каждого каждой каждому
третий: третьих третьими третьим третьему
размер: размере
производиться: производится производиться
новое: нового
право: права праве право
необходимость: необходимость
определенный: определенный
ваш: вашем ваше ваших ваши ваш вашим вашей вашу
отвечать: отвечает
внимание: внимание
трудность: трудностей трудностями
связываться: связаться
россия: россии
подтверждать: подтвердить подтверждают
содержимое: содержимым
включая: включая
покупка: покупкам покупки покупок покупку покупка
проблема: проблем
закон: закона законов закон закону законом законы
возможный: возможным возможные возможного
быть: будут будете будьте будь
лететь: лети
вы: вами
ответственность: ответственности ответственность
оплата: оплаты
обзор: обзора
представление: представлению
сервис: сервисе сервисов сервиса сервис
извещение: извещение
выгодный: выгодная
любой: любая любое любыми любую любые любого любым любой любых любом
выполняться: выполняются выполнялся
компьютер: компьютера компьютере
способ: способы способом способ способами
зарегистрировать: зарегистрированный зарегистрировано зарегистрированное зарегистрированными
один: одну одной одного
стремиться: стремимся
предложение: предложения
ожидать: ожидаемого ожидаемый
служба: службы
другой: другими другим другие другое другая другого других
забывать: забыть
коммерческий: коммерческим
экономить: экономь
законодательство: законодательством законодательство
ситуация: ситуаций
раскладывать: разложили
нравиться: нравится
кошелек: кошельки
дискриминация: дискриминации
находиться: находится находятся находитесь
настоящий: настоящем настоящей настоящее настоящим настоящий
календарный: календарных
ложный: ложным ложных ложном ложной
вносить: внести вносить вносим внесенными
бонус: бонуса бонус бонусы
считаться: считается
товарный: товарными товарных
михаил: михаил
храниться: хранящиеся хранится
какой: каких какие какого какую каким
процент: проценты процент
тот: тех те той
usa: usa
обслуживание: обслуживание
постоянно: постоянно
переговоры: переговоров
также: также
выводить: выводить вывести выводите
комиссия: комиссии
рекламодатель: рекламодателями рекламодатель рекламодатели рекламодателем
коллега: коллега
повлиять: повлиять
сеть: сети сетях сетью
исключение: исключением
претензия: претензий претензии
каталог: каталоге
наниматель: наниматель
использование: использования использование использовании использованием
покупатель: покупателем покупателей покупателю покупателям покупатель покупателя
несвоевременный: несвоевременном
операция: операция операций
посетитель: посетитель посетителей посетителя посетителем
скоро: скоро
сайт: сайта сайт сайте сайтом
новый: новых новой новую новые
включение: включение
передача: передача передачу
защита: защите защита
периодически: периодически
исполнение: исполнению исполнение исполнением исполнения
зарабатывать: зарабатываете зарабатывать зарабатывай
пользователь: пользователем пользователям пользователя пользователю пользователи пользователь пользователями пользователей
определяться: определяется
копировать: копировать
публично: публично
даваться: дается
изменять: изменить изменять
процесс: процесс
соблюдать: соблюдены
высоко: выше
спокойный: спокоен
услуга: услуги услугами услугам услугах услуг
комиссионные: комиссионные
пара: пару
считать: считать считает
доходик: доходик
день: день дней дня
лично: лично
этап: этапе этапах
значит: значит
распоряжение: распоряжения распоряжении
причастный: причастные
например: например
персональный: персональными персональных персональные
который: которых которую который которая которого которой которые которое
пользоваться: пользуюсь пользуемся пользуется
снижение: снижения
фз: фз
нарабатывать: наработали
соответствовать: соответствовать
нереализованный: нереализованными
рассмотрение: рассмотрения
связанный: связанных связанные связанный
мы: нам нами
понравиться: понравилась понравилось
проникновение: проникновения
сделать: сделано сделать сделанные
приз: призов
запись: записи запись
производный: производные
поддерживать: поддерживать
перевод: переводы
учетный: учетная учетную учетной учетные
вирус: вирусов
платежный: платежные платежных
использоваться: используется использовалась
определять: определена определяющим
прекращать: прекращает прекратить
возникать: возникла возникнуть
cooky: cookies
правильный: правильную
деятельность: деятельность
обработка: обработки обработку обработкой
сумма: сумму сумма суммы
отношение: отношений отношения отношение отношении
справедливый: справедливым
регистрация: регистрации регистрация
реклама: рекламы
использовать: использованы использовать использует
точный: точной точным
п: п
приглашать: пригласили приглашайте приглашенного
город: города
инструмент: инструмент
подписываться: подписавшись подписываясь подпишитесь
влиять: влиять влияют
волеизъявление: волеизъявление
завершение: завершения
прекращение: прекращения прекращение
обязанность: обязанности обязанностей обязанность
разрешать: разрешена
акция: акцию акций
никакой: никаких никакой
делать: делала
суть: сути суть
высокий: высокий
пункт: пунктом пунктов пункте пункты
настоящее: настоящего
мера: мере меры
выглядеть: выглядит
невыполнение: невыполнении
пока: пока
технология: технологию технологиях
заведомый: заведомо
несмотря: несмотря
обязываться: обязуется
совокупность: совокупность
сообщение: сообщений сообщения сообщение
контакт: контакты
kubish: kubish
продолжать: продолжать
июль: июля
работать: работает работало работаем
демонстрировать: демонстрировать
качество: качество качества
похожий: похожий
компания: компании компания
согласование: согласование
рубль: рублях рублей
копия: копию
признавать: признаете признает
попытка: попыток попытки
удаление: удаление
возмещение: возмещение
проект: проекты проект
сообщать: сообщаем сообщите сообщая
действительно: действительно
поддержка: поддержки
рекламный: рекламных рекламные рекламной
русский: русском
однако: однако
накопление: накопление накоплений
завершать: завершенная
отказываться: отказаться
обновление: обновление
статья: статья статьи
видеть: видите
повод: поводу
доступ: доступ доступа
информационный: информационные информационной информационных
радовать: радует
оскорбительный: оскорбительной
косвенный: косвенных
необходимо: необходимо
они: ними ими
кэшбек: кэшбек
отзыв: отзыв отзывы отзыва
правило: правила правил правилах
терять: теряю
ясность: ясности
почему: почему
минимальный: минимальная
сделка: сделку сделками сделкам сделках сделки сделок сделка
сомневаться: сомневаться
отправлять: отправить отправлять
сохранять: сохранив сохранен
метод: методом
жалоба: жалобах
заявка: заявки заявке
занимать: занимать
дальнейший: дальнейшем
розыгрыш: розыгрыше розыгрышей
независимый: независимые
промокод: промокоды
извлечение: извлечение
оно: оно
нарушать: нарушены нарушает
обращение: обращения
выраженный: выраженного
антон: антон
причина: причин причинам
среди: среди
e: e
меньший: меньшую
банковский: банковском банковские
указывать: указанной указали
chrome: chrome
важно: важно
оставаться: остаются остается
переводить: переведены перевел
главный: главная
количество: количество
пониматься: понимается
ты: тебе
неудобство: неудобства
карта: карты
частный: частной
окно: окно
собственность: собственности собственность
стабильный: стабильный
форма: форме
стоять: стоит
противоречить: противоречит противоречат
аня: аня
тратить: тратя
непосредственный: непосредственного
указанный: указанных
ст: ст
условие: условия условий условиями условиях
запрашивать: запросить запрашивать
рассылка: рассылку рассылки
осуществлять: осуществлять
присоединять: присоединяет
инорфмация: инорфмация
блокирование: блокирование
нарушение: нарушением нарушение нарушения
потенциальный: потенциальных
купон: купоны купонов
максимально: максимально
средство: средств средства
предлагаться: предлагаются
оговаривать: оговоренные оговорены оговоренных оговоренный
отклонять: отклонены
идти: идти
счет: счете счетом счет счета
подруга: подруга
удобный: удобным
статус: статус
действующий: действующее действующий
мир: миру мира мире
знак: знаках знаками
блокировщик: блокировщик
весь: всей вся
неэксклюзивный: неэксклюзивную
личность: личности
становиться: становитесь стать
принимать: примите принять принимаете принимать
согласие: согласия согласие
заменять: заменяет
помощь: помощью
ссылка: ссылке ссылка ссылки
программа: программа программ
травма: травмы
основание: основании
продвижение: продвижения
противозаконный: противозаконных
манибэк: манибэков манибэка
любить: люблю
негативно: негативно
доступность: доступность
связь: связь связи
то: тому
акт: акты
выплачиваться: выплачиваются
федеральный: федерального федеральному
потеря: потери
должный: должны должной должен
возврат: возврата
сводить: сведен
кухня: кухню
товар: товара товарами товаров товары
поделиться: поделиться
прерывание: прерывание
решать: решать
уничтожение: уничтожение
уведомлять: уведомить
переписка: переписки
действие: действие действием действия действий
друг: друзей друзьями другом друга другу
зависеть: зависит
стабильно: стабильно
установленный: установленных
имя: имя имени
направлять: направленных направить
информация: информацию информации информация
складываться: сложилось
существовать: существует
поставщик: поставщиком
существующий: существующего
выполнение: выполнения
приходить: пришли
qiwi: qiwi
снг: снг
нормальный: нормального
просить: просим
самоустраняться: самоустраняться
подчиненный: подчиненный
интеллектуальный: интеллектуальная интеллектуальной
беспокойство: беспокойство
возмещать: возместить
европа: европе
стараться: стараются
контракт: контракта
комиссионный: комиссионную
сокращать: сократи
aliexpress: aliexpress
технический: техническим техническими технических техническое
общедоступный: общедоступной
особый: особые особых
год: года лет
главное: главное
ущерб: ущербе ущерба ущерб
биткоин: биткоинах
посмотреть: посмотреть
сам: сама
легитимный: легитимные легитимная
порядок: порядке порядка
продавец: продавца продавец продавцу продавцом
создание: создание созданию создании
относиться: относятся относящаяся
оставлять: оставляем оставляет
своевременно: своевременно
авторизация: авторизации авторизация авторизацию
перечислять: перечислены
позволять: позволяют позволяющих позволяет
всякий: всякие
заходить: заходить заходя
случайный: случайных
расход: расходов расходы
политика: политикой
требование: требований требованиям
тренд: тренде
род: рода
специальный: специального
вебмани: вебмани
давно: давно
оперативный: оперативной
правовой: правовым
контроль: контроля
пользовательский: пользовательского пользовательские
недействительный: недействительным
номер: номер
обращать: обратите
момент: моментов момента момент
активировать: активировать
банка: банка
часть: частью части часть
зафиксировать: зафиксирован
оформляться: оформляются
маркетинг: маркетинге
денежный: денежной
проведение: проведение проведения
вход: вход входом
фишка: фишки
клиент: клиент клиенты клиентов
сторона: сторону сторонами стороны
являться: являются является
вышеприведенный: вышеприведенных
посоветовать: посоветовал
предоставление: предоставление
посредством: посредством
выплата: выплаты выплата
контент: контенту
нести: несет несем
приводить: приведут привела
иметься: иметься
хранение: хранение хранения
обеспечение: обеспечения обеспечение
onlinetours: onlinetours
вводить: введя
сбор: сбор
представительство: представительства
распространять: распространять
телефон: телефон телефона
конкуренция: конкуренции
страна: странах
ограничение: ограничений
трансграничный: трансграничную
маркетинговый: маркетинговых
база: базу
поздно: позже
вывод: вывод
идентифицировать: идентифицирующих
буть: буть
пора: пор
организация: организации
червь: червь
свой: своем своей свои своих своего свой
браузер: браузера
производить: произведена
течение: течение
нужно: нужно
отрицательно: отрицательно
торговля: торговле
заключать: заключая
актуальность: актуальность
предварительный: предварительного
молодец: молодцы
степень: степени
убыток: убытки
договоренность: договоренности
достоверный: достоверной
разморозок: разморозки
контактный: контактные контактной контактный
открывать: открыли
веб: веб
вариант: варианты
подарок: подарок подарка
накоплять: накопленные
пожаловать: пожаловать
b: b
явный: явные
практически: практически
выбирать: выбрала
содержать: содержал содержат
искать: искала
получение: получение получения
российский: российской российских
интерес: интересам интересах
поле: поле
различный: различных различные
начисление: начисление
определение: определение
ход: ходе
хороший: лучший хороших
вероятно: вероятно
расширение: расширение расширения расширением
зарегистрироваться: зарегистрироваться зарегистрируйтесь
отслеживать: отслеживать
троянский: троянский
конфиденциальный: конфиденциальную
раздавать: раздавать
конь: конь
неподходящий: неподходящих
совместный: совместного
отмечать: отметить
формирование: формирования
сотрудник: сотрудников
личный: личном личный личных личные личному
сша: сша
одновременно: одновременно
польза: пользу
обезличивание: обезличивание
направление: направления
вправе: вправе
глобальный: глобальной
включать: включенный
защищать: защищены
многий: многими
производство: производстве
шопс: шопс
почитать: почту
интернет: интернетом интернете интернет интернета
приличный: приличный
индия: индии
приемлемый: приемлемым
узнавать: узнаем
yandex: yandex
известный: известные
удовлетворять: удовлетворить
удалять: удалять
понимать: понимаете понять
случай: случаях случае случаев
aviasales: aviasales
роль: роль
менять: меняете
объяснение: объяснения
оказывать: оказываемых
готовый: готовы
совершение: совершения совершении совершению
себя: собой
russia: russia
удачный: удачных
многоуровневый: многоуровневая
добавлять: добавляем
предпринимать: предпринимать
исключая: исключая
забывчивый: забывчивый
человек: людей человек человека
неизменно: неизменно
введение: введение
говорить: говорят говорит
отправляться: отправляются
курс: курсе курс
незамедлительно: незамедлительно
кубышка: кубышки кубышку кубышка
потребитель: потребителей
обсуждать: обсудить
отказывать: отказать
набор: набор
популярный: популярный популярные
отмена: отмены
изменяться: изменится
логин: логин
осуществление: осуществление
страх: страх
огромный: огромную
доставка: доставкой доставки доставку
довольно: довольно
реальный: реальными реальный
больший: большей
хранить: храним
прислушиваться: прислушиваются
ксения: ксения
cashback: cashback
изменний: изменний
дополнительный: дополнительным дополнительных дополнительные
вышеизложенный: вышеизложенного
достоверно: достоверно
хабрь: хабре
никто: никто
яндекс: яндекс
версия: версию
следить: слежу
gearbest: gearbest
сервисный: сервисные
план: плане
финансовый: финансовом
ольга: ольга
опрос: опросов
жизнь: жизни
некоторые: некоторые некоторых
это: это
неделя: недели
поскольку: поскольку
соответствующий: соответствующего
ситилинк: ситилинк
акцепт: акцепта
сведение: сведения сведению
событие: событие
компьютерный: компьютерную
добавление: добавления
сила: силу силе
осуществляться: осуществляется
федерация: федерации
знать: знаю
принятие: принятия
собираться: собираетесь
законность: законность
нажимать: нажать
тип: типа
понадобиться: понадобится
владеть: владеем
телефонный: телефонных
впечатление: впечатление
вызывать: вызванные вызвать
созревать: созреет
вопрос: вопросами вопросы вопрос
частично: частично
однозначно: однозначно
заявление: заявления
обязательство: обязательства обязательств
пароль: пароль
c: c
ряд: ряд
сфера: сфере
последующий: последующей последующем
пакет: пакете
начислять: начисленный
угроза: угрозы
далее: далее
информировать: информирующие
автоматизация: автоматизации
никой: никоим
оптимизация: оптимизации
несколько: несколько
неисключительный: неисключительное
активный: активный
списывать: списан
должно: должно
обещать: обещаем
воспользоваться: воспользовавшись
согласно: согласно
следующий: следующее следующую следующими
появляться: появляется
прояснивать: прояснить
полный: полной полное полном
шустрый: шустрая
отдельность: отдельности
информационно: информационно
sm: sms
ключевой: ключевую
ребята: ребята
вноситься: вноситься
минимально: минимально
вершина: вершине
заказ: заказа заказе заказов
отказ: отказа отказе
прошерстить: прошерстила
несанкционированный: несанкционированного
участвовать: участвовать участвует участвуют
рука: рукой
продукт: продуктам
предотвращать: предотвращать
основываться: основываясь
постараться: постараемся
ip: ip
целый: целый
отменять: отменены отменена
лабиринт: лабиринт
соответствие: соответствии
интересный: интересная
требоваться: требуется
основа: основа
отдельный: отдельные
путем: путем
адрес: адресом адрес адресе
положение: положений положения
общий: общем общие
оператор: операторов
содержание: содержание
отключать: отключить
письмо: письма
блог: блог
функционирование: функционирования
письменный: письменного
разногласие: разногласия
рф: рф
статистика: статистики
регулироваться: регулируются
прямой: прямые
участник: участников участнику
реферал: рефералов
регион: регионы
счесть: счесть
конфиденциальность: конфиденциальность конфиденциальности
т: т
макровирус: макровирусов
недоступный: недоступны
сервер: серверах
показание: показаниях
клеветнический: клеветнической
реферальный: реферальная реферальном реферальной реферального
называть: названы
основной: основных
настройка: настройках
неявный: неявные
очередь: очередь
граф: графа
особенность: особенности
booking: booking
замечание: замечание
внесение: внесении
документ: документом
предприятие: предприятия
адекватный: адекватную
присылать: пришлем
устанавливать: установить устанавливайте
ввиду: ввиду
полностью: полностью
косяк: косяки
компенсация: компенсация
protected: protected
доступный: доступный доступными
ответственный: ответственен
прежде: прежде
компетенция: компетенцией
функционировать: функционирует
автоматически: автоматически
язык: языке
минимум: минимуму
добро: добро
сублицензия: сублицензию сублицензии
установление: установления
попросить: попросить
вид: вида
adblock: adblock
субконтрактор: субконтрактору
www: www
знакомый: знакомых
регулировать: регулировать
надоедать: надоедает
устранять: устранить
либо: либо
вступать: вступают
недоступность: недоступности
тайный: тайный
перечень: перечень
вспоминать: вспоминала
начинать: начинали начинают
смерть: смерти
поэтому: поэтому
мгновенно: мгновенно
приостанавливать: приостановить
все: всему всем всеми
почта: почты
меняться: меняется
подобный: подобны подобные
публичный: публичной
прямо: прямо
означать: означает
свое: свое
немедленно: немедленно
объем: объеме
систематизация: систематизацию
прочитывать: прочитать
давний: давний
faq: faq
английски: английски
ожидание: ожиданиям
ru: ru
работа: работу работе
живой: живые
именовать: именуемой
отдельно: отдельно
неисполнение: неисполнении
собственный: собственном
б: б
проверять: проверяем
правый: прав
бездействие: бездействием
сопровождать: сопровождающей
созревание: созревания
информирование: информирования
принадлежащий: принадлежащие
человка: человка
старый: старых
некорректный: некорректно
реализовать: реализованными
вышесказанный: вышесказанное
подозревать: подозреваете
f: f
д: д
осторожность: осторожность
обрабатываться: обрабатывается
время: время времени
com: com
предыдущий: предыдущие
причинять: причиненный
число: числе
замораживать: замораживаем
коммуникационный: коммуникационных
оговариваться: оговариваются
разговор: разговоров
техподдержка: техподдержка
выполнять: выполнив
образ: образом
раздражение: раздражение
интерактивный: интерактивные
доход: дохода
выявлять: выявлены
нужный: нужна
frendi: frendi
неприкосновенность: неприкосновенности
соглашаться: соглашается
путь: путь
подтверждение: подтверждения
уведомление: уведомлений
проявлять: проявлять
наносить: нанесен
заинтересовываться: заинтересуетесь
случаться: случившиеся
разрешение: разрешения
расторгать: расторгнуть
просьба: просьбой
доллар: долларах
ознакомление: ознакомления
евро: евро
anywayanyday: anywayanyday
держать: держать
абонент: абонента
упоминать: упомянутые
одобрение: одобрения
смочь: сможете
премия: премия
ото: ото
подарочный: подарочный
лицензия: лицензию
дистанционный: дистанционной
системный: системных
корреспонденция: корреспонденция
поиск: поиск
контролировать: контролируй
доля: долю
невзирая: невзирая
представлять: представим
оферта: оферты
односторонний: одностороннем
период: период
поменять: поменяйте
выражать: выраженное
анализ: анализ
регистрироваться: регистрировалась
немой: нем
постоянный: постоянную
