омич: омич
ваш: вашего
телеканал: телеканалы телеканал
скандал: скандал
появляться: появиться появится
снова: снова
gameplay: gameplay
одобрять: одобрил
онлайн: онлайн
разгуливать: разгуляй
фильм: фильмы фильм фильма
украина: украине
добавлять: добавить
зонирование: зонировании
защитник: защитникам
медведь: медведь
дорога: дорога
rutube: rutube
рекомендовать: рекомендуем
ivlev: ivlev
ю: ю
приставка: приставки
полный: полное
хороший: хорошего
девушка: девушку
сад: сад
главный: главная
газета: газета
послание: послание
огород: огород
такси: такси
конфиденциальность: конфиденциальность
видео: видео
gone: gone
вечеринка: вечеринок
наш: наши
цветняшка: цветняшки
урожайный: урожайный
т: т
серия: серия
рен: рен
пол: пол
модница: модница
кудрявцева: кудрявцевой
таксовать: таксую
xeon: xeon
уведомление: уведомления
малина: малиной малина
древний: древний
мечта: мечты
распад: распад
тип: типы
виталий: виталий
верхний: верхней
уход: уходу
форсаж: форсаж
собака: собак
обстрел: обстреле
ринго: ринго
новое: новое
проходить: проходят
клуб: клуб
концерт: концерт
алый: ал
идея: идеи
день: день дней дня
зажигание: зажигание
машина: машине
po: po
карлос: карлос
кемер: кемер
ребенок: детей детям
направление: направления
hitman: hitman
tilka: tilka
гуляш: гуляша
блогер: блогеры блогеров
санкция: санкций
возвращаться: возвращается
backstage: backstage
митинг: митинг
маркер: маркерами
обратный: обратная
сода: соды
tatarochka: tatarochka
нефть: нефть
fitstars: fitstars
зуб: зубы
есть: едим
каталог: каталог
р: р
амара: амарой
самый: самые самой
здоровый: здоровыми
песенка: песенка
сердце: сердце
луномосик: луномосик
gstv: gstv
награждать: награждены
час: часов час часа
вкусный: вкусные
hd: hd
мур: мур
жигули: жигулях
дядя: дядя
хейтер: хейтеры
соглашение: соглашение
линников: линникова
вечный: вечный
торпедо: торпедо
kinomэn: kinomэn
здоровье: здоровье
дас: дас
документальный: документальный
стс: стс
пакет: пакет
граммовка: граммовками
город: городе
лайфхаки: лайфхаки
желание: желании
экстрасенс: экстрасенс
котенок: котенок
философия: философии
двигатель: двигатель
илья: илья
альтернативный: альтернативной
комната: комнаты
новый: новый новом
рецепт: рецепт
топ: топе топ
россия: россии россия
простой: простой
посиделки: посиделки
криминальный: криминальном
stand: stand
auto: auto
связь: связь
lisa: lisa
выступать: выступил
газпром: газпром
tube: tube
terra: terra
юмор: юмор
voda: voda
красить: крашу
юрий: юрий
весна: весну
хилый: хилая
импровизация: импровизация
эконом: эконом
skidkam: skidkam
один: одной
kate: kate
horizon: horizon
петербург: петербург
artilera: artilera
зря: зря
пробовать: пробует
сми: сми
life: life
сюзетт: сюзетт
zak: zak
award: awards
обучение: обучение
мари: мари
блинчик: блинчики
молоко: молоко
энергетика: энергетике
дизайнер: дизайнер
музloft: музloft
настраивать: настроить
анна: анна
мультфильм: мультфильм мультфильма
communication: communications
смерть: смерти смерть
подкаста: подкасты подкаст
купить: купить
вечерок: вечерки
мная: мная
зритель: зрителями
подоляк: подоляка
channel: channel
play: play
свой: своих
санкт: санкт
путин: путина
матч: матч
звезда: звезда
газ: газ
тема: тема
оставлять: оставить
видеоигра: видеоигры
год: год
спасать: спас
реальноя: реальнои
жизнь: жизни жизнь
rtx: rtx
live: live
ночной: ночная
батя: батя
settler: settlers
успех: успехи
никакой: никаких
сон: сна
test: test
ядерный: ядерные
мочь: могут
комфорт: комфорт
крем: крем
вс: вс
покидать: покинет
алена: алена
одежда: одежды
свет: света
родиться: родиться
returnal: returnal
пятница: пятница
друзея: друзеи
прохождение: прохождение
реальный: реальной
ответ: ответы
доставать: достать
поездка: поездка
российский: российская
original: originals
ru: ru
ч: ч
среда: среду
digital: digital
история: история
заигрыш: заигрыши
креп: креп
русский: русская
позор: позор
путешествие: путешествия
trine: trine
музыка: музыка
союзмультфильм: союзмультфильм
яндекс: яндекс
распродажа: распродажа
совет: советы
говорить: говорит
альбом: альбоме
спаляться: спалился
назад: назад
че: че
шоу: шоу
переход: переход
радио: радио
дмитрий: дмитрий
психология: психология
солнцев: солнцев
знакомство: знакомство
твц: твц
пострадавший: пострадавших
day: days
конфета: конфеты
число: число
иначе: иначе
популярность: популярности
это: это
нож: ножи
yorker: yorker
скачивать: скачивайте
пиар: пиар
fide: fide
переходить: перейдет
косметика: косметикой
ночь: ночь
бойфренд: бойфренд
sudarikova: sudarikova
shakamalov: shakamalov
телешоу: телешоу
черный: черный
кошмарный: кошмарный
заканчиваться: закончится
романовский: романовская
должность: должность
становиться: стала
геркус: геркус
холдинг: холдинга
татарка: татарка
спорт: спорт
еда: еда
федерация: федерации
цветной: цветные
metametrica: metametrica
покормить: покормили
тв: тв
большой: большой большом
испытание: испытания
новость: новости
приют: приют
fm: fm
яморе: яморе
политика: политика
традиция: традиции
простоквашино: простоквашино
самомассаж: самомассаж
gid: gid
тасс: тасс
игра: игр
пригожин: пригожин
отечество: отечества
против: против
stone: stones
шойгу: шойгу
добрый: доброе
президент: президента
страна: страны
пятый: пятый
помощь: помощи
масленица: масленица
лужники: лужниках
клип: клип
краймбрери: краймбрери
луковица: луковица
раскручивать: раскручивают
два: две
азия: азию
высыпаться: выспимся
показывать: показываем
show: show
голливуд: голливуде
отношение: отношении
rate: rate
правовой: правовая
интервью: интервью
сохранять: сохранить
подписываться: подписывайтесь
использовать: использовать
никотин: никотин
стеклянный: стеклянная
наброс: набросов
legacy: legacy
родитель: родители
сериал: сериалы
часть: часть
viju: viju
тариф: тариф
стрим: стримов
стрелка: стрелки
съездить: съездили
музыкальный: музыкальный
ивлев: ивлева
fail: fail
возрастать: возросло
слава: славы слава
диденко: диденко
вопрос: вопросы
канал: канал
возможность: возможности
vlog: vlog
белый: белый
медиа: медиа
шахматы: шахмат
new: new
атомный: атомное
ужасный: ужасные
инструкция: инструкции
frame: frame
вселенная: вселенная
квест: квест
первый: первый
семья: семья
информация: информация
music: music
chef: chef
шурыгин: шурыгина
mouse: mouse
красота: красота
актер: актер
salakhiev: salakhiev
приложение: приложения
чебурашка: чебурашкой
heart: heart
тещин: тещины
тнт: тнт
x: x
жестко: жестко
тренд: тренды
ради: ради
агроном: агронома
nil: nil
весь: весь
категория: категории
хаметова: хаметовой
й: й
atomic: atomic
война: война
домашний: домашний
орехов: орехов
культура: культура
ес: ес
встреча: встреча
музлофт: музлофт
прошлое: прошлом
apple: apple
обзор: обзор
дома: дома
золовкин: золовкины
авто: авто
лорак: лорак
мини: мини
tv: tv
акт: акт
трансляция: трансляции
света: свете
hogwarts: hogwarts
магазин: магазине
урожай: урожаем
marksayks: marksayks
рассказывать: рассказал
kia: kia
деятельность: деятельности
smart: smart
старра: старр
артемовский: артемовском
лакомка: лакомка
oblomoff: oblomoff
мнение: мнение
фонд: фонды
этаж: этажи
милан: миланы
velvet: velvet
способ: способ
мир: мир
rolling: rolling
шебекино: шебекино
праздник: праздника
мисс: мисс
блин: блин
входить: войдите войти
кострома: костроме
питер: питере
сатья: сатьи
новинка: новинки
пользовательский: пользовательское
отзыв: отзыв
вич: вич
съемка: съемки
стоматолог: стоматолога
нтв: нтв
cerato: cerato
смог: смог
муза: муз
проводы: проводы
сделать: сделать
макияж: макияже
magazine: magazine
проект: проекты
заваливать: завалит
х: х
календарь: календарь
центр: центр
три: трех
маккартень: маккартни
p: p
шеф: шефа
стильный: стильной
artem: artem
идеальный: идеальными
согласовывать: согласовать
