чистый: чистом
учебник: учебник
выражение: выражений выражения
асинхронность: асинхронность
клиент: клиент клиенте
букмарклет: букмарклеты
добро: добро
секунда: секунда
знание: знаний
быстрый: быстрой
элемент: элементы элемента
конструкция: конструкции
конкретный: конкретном
регулярный: регулярных регулярные
редактирование: редактирование
помогать: помогите
жить: живет
связь: связь
объект: объекты
шаблонизация: шаблонизация
rich: rich
selenium: selenium
watch: watch
это: это
cookie: cookie
час: часов
сайт: сайт сайте сайта сайту
зависимость: зависимостей
frequently: frequently
хороший: лучших лучшие
новый: новый
впервые: впервые
аналог: аналоги
работа: работа
интерфейс: интерфейс интерфейсы
documentfragment: documentfragment
client: client
gear: gears
грамотный: грамотное грамотную
умный: умное
кеширование: кеширование
mobile: mobile
форум: форуме форуму форум
версионность: версионность
shared: shared
язык: языку языка
тема: темы
базовый: базовые
nice: nice
отладка: отладка
comet: comet
подборка: подборке
ошибка: ошибок
минута: минута минут минуты
замыкание: замыкания
идентификация: идентификации
комментарий: комментарии комментарий
сообщение: сообщений сообщения
прочь: прочь
интеграция: интеграция
кантор: кантор
обработка: обработка
способ: способы
drag: drag
сжимаемость: сжимаемость
почитать: почитать
отображать: отображать
движок: движок
домен: доменов доменами
статья: статей статьи
allow: allow
написать: написать
программирование: программирование
flash: flash
biobet: biobet
post: post
информация: информацию
скрипт: скрипт скриптов
больший: большая
html: html
сервер: сервером
storage: storage
общение: общения
данный: данных
обмен: обмен
href: href
введение: введение
тип: типы
основа: основы
javascript: javascript
уровень: уровни уровня
closure: closure
шаг: шагов
excellent: excellent
адрес: адресу
part: part
перевод: перевод
небольшой: небольшой
основной: основные
материал: материалов
trust: trust
серверный: серверная
связка: связке
современный: современный
j: js
событие: события
функция: функций функции
рекомендовать: рекомендую
массив: массивы
тест: тест тесты
профессиональный: профессиональный
проверка: проверка
структурированный: структурированную
разный: разных разное
архитектура: архитектура
англоязычный: англоязычных
удобный: удобное
улучшать: улучшаем
discord: discord
антисп: антиспам
оператор: операторы
мост: мост
формат: форматы
правило: правила
цель: цель
сжатие: сжатие
последний: последние
dom: dom
действие: действие
ооп: ооп
интернет: интернете
вход: вход
compiler: compiler
документ: документов
инструмент: инструментами
advice: advice
страница: странице страницей страниц
information: information
wallet: wallet
toggle: toggle
cs: css
полезный: полезное
юнит: юнит
сборка: сборки
overview: overview
смежный: смежным
система: система
стандарт: стандарт
особенность: особенности
написание: написания
алгоритм: алгоритма
живой: живого
обратный: обратная
плохо: плохо
yslow: yslow
ускорение: ускорения
php: php
блок: блоке
сундучок: сундучок
поиск: поиск
браузер: браузера
просмотр: просмотр
c: c
расширять: расширенный
скринкаста: скринкаст
находиться: находится
ознакомляться: ознакомиться
сортировка: сортировки
справочник: справочники справочник
drop: drop
boolean: boolean
http: https http
обучение: обучения
строка: строки
число: числа
дерево: дерево
show: show
really: really
технология: технологиям
think: think
mvc: mvc
provide: provide
website: websites
pretty: pretty
вверх: вверх
google: google
kick: kick
cool: cool
польза: польза
регистрация: регистрация
ajax: ajax
incredibly: incredibly
деталь: деталях
подгрузка: подгрузкой
перенести: перенесена
ru: ru
обзор: обзором
почему: почему
yahoo: yahoo
запуск: запуск
краткий: кратким
данные: данными
need: need
хранение: хранение
one: one
книга: книг
writing: writing
часть: часть
асинхронный: асинхронное
проект: проекте
курсы: курсы
чат: чат
правильный: правильные
который: который
датасет: датасет
назад: назад
координата: координаты
анализ: анализ
node: node
e: es
содержание: содержание
запрет: запрет
оптимизация: оптимизация оптимизации
take: take
код: кода
learn: learn
forum: forum
изменять: изменить
илья: илья
пожаловать: пожаловать
library: library
предоставлять: предоставить
hide: hide
