полезный: полезные
вид: видов
состояться: состоятся
подробно: подробнее
продукт: продукта продукты
палитра: палитре
светлый: светлый
участие: участие
клясть: кляты
сбор: сбора
отель: отеле
посещать: посетить
фрукт: фруктов
экологический: экологической экологическая
акция: акции акция
принимать: принять
это: это
южный: южного южной
поле: поле
цветение: цветение цветению
содействие: содействие
сайт: сайте
приветствоваться: приветствуется
растение: растений
день: день дней
детский: детское
биржа: биржа
дерево: деревьев
плодовый: плодовых
место: место
приходить: приходит
дон: дону
поражать: поражает
район: районе
сад: сад
декоративный: декоративных
мед: меда мед
количество: количество
весенний: весенних весенний
просто: просто
переговоры: переговоры
подарить: подарила
темерник: темерник
осенний: осеннего
весна: весна
футбольный: футбольное
область: область области
находить: найдете
компания: компаний
громкий: громких
который: которое
контакт: контактов контакты
партнер: партнерами
т: т
регион: региона
купеческий: купеческий
красочный: красочной
река: реке
феерия: феерия
каштановый: каштановый
событие: событий
видеоблог: видеоблог
один: одним
пр: пр
цвеотв: цвеотв
соскучиться: соскучился
другой: другие
navigation: navigation
суворовский: суворовский
г: г
мы: нам
зелень: зелень зелени
ростов: ростов ростове
воспевать: воспетая
новость: новости
говорить: говорить
осень: осень
ценный: ценного
д: д
турецкий: турецкой
вкус: вкусу вкусе
платон: платона
рэдиссон: рэдиссон
приглашать: приглашает
время: время
ежегодный: ежегодная
дыхание: дыхание
свежесрезанный: свежесрезанных
rostov: rostov
право: праву
ростовский: ростовскую ростовской
мероприятие: мероприятии мероприятие мероприятия
всемирный: всемирный
ярмарка: ярмарка
выдающийся: выдающимися
саженец: саженцев
считаться: считается
экспресс: экспресс
toggle: toggle
встречать: встретить
столица: столице
проведение: проведению
карамель: карамель
спорить: спорить
романтика: романтика
природа: природы
цветок: цветов
обязательно: обязательно
многий: многими
производитель: производители
kupec: kupec
состав: составе
ростовчанин: ростовчан
info: info
тот: тех
горизонт: горизонт
михаил: михаила
фестиваль: фестивалем
открываться: открылась
международный: международная
сочный: сочной
бизнес: бизнес
сельскохозяйственный: сельскохозяйственных
чистота: чистоты
также: также
сентябрь: сентября
совместно: совместно
год: лета
турция: турции
выставка: выставке выставка
вместе: вместе
нужно: нужно
польза: пользе
финансовый: финансовое
поэт: поэтами
лето: лето
темный: темный
оказывать: оказать
летний: летнюю
позвонить: позвоните
гость: гостей
ожидать: ожидает
ул: ул
пшеница: пшеница
готовый: готовых
данный: данное
ru: ru
кск: кск
делегация: делегации
п: п
пчеловодство: пчеловодства
нагибина: нагибина
пышный: пышная пышному
краса: красу
окунаться: окунуться
город: города
пестрый: пестрое
тпп: тпп
организационный: организационное
погружать: погрузив
парк: парк
миссия: миссия
последний: последнее
проект: проекту
аромат: аромат
несколько: несколько
позволять: позвольте
фотоотчет: фотоотчеты
просыпаться: просыпающейся
декаданс: декаданса
час: часами
акациевый: акациевый
рад: рады
