компрессор: компрессоры
реферат: рефераты
уфология: уфология
занятость: занятость
коммуникация: коммуникации
дачный: дачные
квн: квн
бухучет: бухучет
ролевой: ролевые
e: e
сауна: сауны
бар: бары
онлайн: онлайн
орган: органы
музей: музеи
банковский: банковские
химия: химия
элемент: элементы
кастинг: кастинг
кость: кости
фильм: фильмы
дом: дом
ребенок: дети
centrsidelok: centrsidelok
бытовой: бытовая
рассылка: рассылки рассылка
хореография: хореография
место: место
звукозаписывающий: звукозаписывающие
экономика: экономика
транспорт: транспорта
манга: манга
сад: сад
бодибилдинг: бодибилдинг
суп: супы
главный: главная
огород: огород
жилить: жиль
книга: книги
спутниковый: спутниковая
афиша: афиша
малый: малый
регион: регионов регионы
фоторамка: фоторамки
хип: хип
карта: карты
видео: видео
живопись: живопись
приправа: приправы
энциклопедия: энциклопедии
железо: железо
плазма: плазма
аутплейсмент: аутплейсмент
электромобиль: электромобили
психологический: психологические
tech: tech
почта: почта
инструмент: инструменты
парогенератор: парогенераторы
литература: литература
гольф: гольф
ремонт: ремонт
монтаж: монтаж
заочный: заочное
детский: детский
анекдот: анекдотов анекдоты
ученый: ученые ученых
северный: северная
клуб: клубы клуб
ресторан: рестораны
америка: америка
фиксировать: фиксированный
абсурдизм: абсурдизмы
самбо: самбо
бухгалтерский: бухгалтерский
бетон: бетон
колледж: колледжи
реклама: рекламу рекламы реклама
поэзия: поэзия
футбол: футбол
дистанционный: дистанционное дистанционная
публикация: публикации
детская: детская
застройщик: застройщиков
арт: арт
бассейн: бассейна
новостной: новостной
водный: водный водные
исскуство: исскуства
synthelp: synthelp
талисман: талисманы
покер: покер
гостиница: гостиницы
страничка: страничку
словарь: словари
стратегический: стратегический
спортивный: спортивная спортивные спортивный
отход: отходов
материал: материалы
доска: доска доски
финансовый: финансовые
софт: софт
безопасность: безопасности безопасность
урок: уроки
металлургия: металлургия
точный: точные
антиквариат: антиквариат
пранк: пранк
утилита: утилиты
средство: средства
модный: модная
защищать: защищены
запись: записи
журналистика: журналистика
обувь: обувь
страхование: страхование
каталог: каталог каталоге каталоги каталога
комната: комната
журнал: журналы
модельер: модельеры
интернет: интернет
песня: песен
мобильный: мобильная мобильные
краснодар: краснодаре
нетрадиционный: нетрадиционная
транспортный: транспортные
трудоустройство: трудоустройство
http: https http
самый: самые
графика: графика
сообщество: сообщества
машиностроение: машиностроение
танец: танец
экстримальный: экстримальные
одежда: одежды одежда
гимназия: гимназии
город: города городов
производство: производство
отдых: отдых
бизнес: бизнеса бизнес
автострахование: автострахование
переработка: переработка
хозяйка: хозяйка
ua: ua
азия: азия
кино: кино
секс: секс
ковать: кованные
сектор: сектора
шутка: шутки шуток
известный: известные
кирпичный: кирпичный
компьютер: компьютеры
творчество: творчество
карточный: карточные
африка: африка
право: права право
автомагазин: автомагазины
энергия: энергии
магия: магия
здоровье: здоровье
обзор: обзоры
визитка: визитки
популярный: популярные
вещь: вещи
трава: травы
нии: нии
исследование: исследование исследования
энергетика: энергетика
возобновлять: возобновляемые
европа: европа
программа: программ программы
бесплатно: бесплатно
естественный: естественные
рейтинг: рейтинги
продажа: продажа продажи
кафедра: кафедры
опт: оптом
фитнес: фитнес
дискотека: дискотеки
эмо: эмо
антивирус: антивирусы антивирус
ди: ди
общественность: общественностью
игрушка: игрушки
власть: власть власти
игра: игры
ислам: ислам
наука: науки наука
высокий: высшее
телефония: телефония
пища: пищи
издание: издания
пресса: пресса
связь: связь связи
apteka: apteka
йога: йога
графический: графический
хобби: хобби
юморист: юмористы
джитсу: джитсу
коммерция: коммерция
бижутерия: бижутерии
корзина: корзины
миллион: миллион
гора: горы
потолок: потолки
юмор: юмора юмор
овощной: овощные
аналитика: аналитика
форум: форумы
мебель: мебель
деревообработка: деревообработка
сервис: сервисы сервис
спальня: спальня
салат: салаты
учет: учет
синтезатор: синтезаторах
регистрация: регистрация регистраций
мода: мода моде
www: www
оборудование: оборудование
фотоискусство: фотоискусство
часы: часы
целительство: целительство
руб: руб
khark: khark
агентство: агентства
биография: биография
система: системы
лесной: лесное
вторсырье: вторсырья
боевой: боевые
бад: бадов
охранный: охранная охранные
усадьба: усадьба
группа: группы
hi: hi
океания: океания
фурнитура: фурнитура
свой: свой
сми: сми
становиться: стать
поставлять: поставить
болезнь: болезни
умелый: умелые
автоматизация: автоматизация
обучение: обучение обучении
телефон: телефоны
умный: умный
исполнитель: исполнители
вокал: вокал
джей: джеи
доставка: доставка
электричество: электричество
социология: социология
текст: тексты
инвестиционный: инвестиционные
top: top
маршрут: маршруты
очищение: очищение
фэн: фэн
купить: купить
личный: личная личные
данные: данные
вид: виды
технология: технологии
рубрика: рубрики
вооружение: вооружение
генеалогия: генеалогия
тво: тво
театр: театр
баскетбол: баскетбол
женский: женское женской
кадровый: кадровые
зооклуб: зооклубы
камера: камеры
окно: окна
электроника: электроника
апдейта: апдейты
форма: форм
голодание: голодание
видеоигра: видеоигры
вебмастер: вебмастер
аэрография: аэрография
практика: практика
природа: природа природе
операционный: операционные
фу: фу
шар: шары
календарь: календари календарь
массаж: массаж
участок: участки
рулетка: рулетка
менеджер: менеджеры
жизнь: жизнь
файл: файлы
романтика: романтика
музыковедение: музыковедение
премиум: премиум
школа: школы
нко: нко
искусство: искусство
комфорт: комфорт
развлечение: развлечения
план: планы план
факс: факсы
социальный: социальные
информация: информации
автомобиль: автомобили
мастер: мастера
лес: леса
чебоксары: чебоксарах
рыбный: рыбное
закон: законы
гипотеза: гипотезы
мужской: мужское мужской
faq: faq
пол: полы
когенерация: когенерация
подарочный: подарочная подарочные
поисковый: поисковые
готовить: готовим
блок: блок
учебный: учебные
чат: чаты
ароматерапия: ароматерапия
пинхол: пинхол
экология: экология
недвижимость: недвижимости недвижимость
консервирование: консервирование
magicclay: magicclay
воздух: воздуха
гадание: гадания
джиу: джиу
мобильник: мобильники
автосправочник: автосправочники
ru: ru
мониторинг: мониторинг
men: men
эзотерика: эзотерика
макияж: макияж
история: история
цена: цены
школьный: школьные
путешествие: путешествия
сайт: сайта сайтов сайт сайты
строительство: строительство
музыка: музыка
стиль: стили
адрес: адреса
гот: готы
ооо: ооо
учеба: учеба
база: базы
равнина: равнины
ушу: ушу
ссср: ссср
навигация: навигации
промышленный: промышленные
электронный: электронная
защита: защита
кунг: кунг
блюдо: блюда
успешный: успешная
конструктор: конструктор
топливный: топливные топливная
ссылка: ссылку
скульптура: скульптуры
макароны: макаронах
домашние: домашние
аудио: аудио
радио: радио
первый: первая
вентиляция: вентиляции
волейбол: волейбол
товар: товары
телевидение: телевидение
колесо: колесо
ресурс: ресурсы ресурсов
киноискусство: киноискусство
газета: газеты
работа: работы работ работа работе
карьера: карьера
гуманитарный: гуманитарные
хоккей: хоккей
кошка: кошки
лые: лые
cd: cd
закуска: закуски
агропром: агропром
подросток: подростки
пожарный: пожарная
безработица: безработица
pool: pools
резюме: резюме
аниме: аниме
афоризм: афоризмы
kz: kz
su: su
прививка: прививки
окружающий: окружающая
поздравительный: поздравительные
интерфейс: интерфейс
сеть: сетей сети
рынок: рынка рынок
gidrosv: gidrosv
компьютерный: компьютерные
мультимедиа: мультимедиа
список: списки
уют: уют
объявление: объявления объявлений
борьба: борьба
черный: черный
написать: написать
частный: частная
персональный: персональные
файловый: файловые
непознанный: непознанное
программирование: программирование
воздушный: воздушные
драма: драма
событие: событий
создание: создание
спорт: спорт
карикатура: карикатуры
услуга: услуги
мы: нам
системный: системные
бутик: бутики
прямой: прямой
приборостроение: приборостроение
sanitas: sanitas
новость: новости
политика: политика
рецепт: рецепты
семинар: семинары
медицина: медицина
рисование: рисование
напиток: напитки
прибор: приборы
розыгрыш: розыгрыши
gid: gid
велосипед: велосипеды
com: com
поселок: поселки
кулинария: кулинария
продукт: продуктов продукты
маркетинг: маркетинг
хиппи: хиппи
правило: правила
южный: южная
студент: студентов
последний: последние
астрология: астрология
статистика: статистика
пазл: пазлы
телемаркетинг: телемаркетинг
техника: техника
вуз: вузы
врач: врача
покрытие: покрытия
officetrade: officetrade
питание: питания
выставка: выставки
источник: источники
картинка: картинки
отношение: отношения
азартный: азартные
хоп: хоп
ведущий: ведущие
цифровой: цифровые
растение: растения
партнер: партнером
топливо: топливо
контекстный: контекстной контекстная
формула: формула
предмет: предметы
страна: страны
образование: образование
mp: mp
статуэтка: статуэтки
дата: дат
студенческий: студенческая
погода: погода
деятельность: деятельность
кредит: кредиты
арктика: арктика
размещать: разместить
животное: животные
теория: теории
гараж: гаражи
заказывать: заказать
домашний: домашнее домашний
персонал: персоналом
weentu: weentu
кинопроизводство: кинопроизводство
управление: управление
модель: модели
вакансия: вакансии
россия: россия
антарктика: антарктика
терапия: терапия
тренинг: тренинги
геймер: геймеры
parogenerator: parogenerator
инфопортал: инфопортал
market: market
гаджет: гаджеты
марафон: марафон
лыжный: лыжный
энерготехнология: энерготехнологии
офис: офиса
лизинговый: лизинговые
информагентство: информагентство
ателье: ателье
выпечка: выпечка
курсы: курсы
посуда: посуда
зарубежный: зарубежная
трансгендер: трансгендеров
микромаркетинг: микромаркетинг
метод: методы
магазин: магазин магазины
plazma: plazma
мотоцикл: мотоциклы
брендинг: брендинг
разный: разное
изготовление: изготовление
активный: активный
комплекс: комплексы
санаторий: санатории
наблюдение: наблюдение
сертификат: сертификаты
аптека: аптека
поле: поля
блог: блоги
панк: панки
airpump: airpump
столовый: столовые
аудит: аудит
полиграфия: полиграфия
собака: собаки
sa: sa
семья: семья
сервер: сервера
оп: оп
хозяйство: хозяйство
мистика: мистика
электротехника: электротехника
инвентарь: инвентарь
автозапчасть: автозапчасти
club: club
общественный: общественные
ванная: ванная
дженерик: дженериков
контроль: контроль
кулинарный: кулинарные
фото: фото
ипотека: ипотека
seoca: seoca
карате: каратэ
красота: красота
фестиваль: фестивали
садоводство: садоводство
портфолио: портфолио
скинхед: скинхеды
звуковой: звуковые
септик: септика
оцифрованный: оцифрованный
автоспорт: автоспорт
настольный: настольные
web: web
дизайн: дизайн
категория: категории
галерея: галереи
arte: arte
развлекательный: развлекательные
вес: вес
человек: люди людей
учебник: учебники
пейнтбол: пейнтбол
денежный: денежный
кикбоксинг: кикбоксинг
стена: стены
familyshop: familyshop
алкогольный: алкогольные
забава: забавы
юмористический: юмористические
косметология: косметология
актер: актеры
снимок: снимки
культура: культура
тюнинг: тюнинг
концерт: концерты
коммерческий: коммерческая
консультация: консультация
подарок: подарки
генератор: генераторы
пирсинг: пирсинг
диета: диета
исцеление: исцеления
профессиональный: профессиональный
боди: боди
допуск: допуски
архитектура: архитектура
айкидо: айкидо
счетчик: счетчики
буддизм: буддизм
авто: авто
армия: армия
комикс: комиксы
нудист: нудисты
промышленность: промышленность
аренда: аренда
туризм: туризм
знакомство: знакомства
alpha: alpha
развлекаться: развлечься
кухня: кухня
электростанция: электростанции
государство: государство
средний: среднее
фотоаппарат: фотоаппараты
певец: певцы
персоналия: персоналии
общество: общество
банк: банки
рукоделие: рукоделие
фотограф: фотографы
крутить: крути
научный: научные
организация: организации
статья: статьи
шуя: шуй
религия: религия
твердый: твердое
service: service
няня: няни
фонд: фонды
жанр: жанры
праздник: праздники
рука: руки
мир: мир
международный: международные
pro: pro
поиск: поиск
изделие: изделия
экономический: экономические
среда: среды среда
австралия: австралия
баннерный: баннерные
kris: kris
подписка: подписка
художник: художники
стоянка: стоянки
справочник: справочники
вебинара: вебинары
напольный: напольные
страница: страницы
сетевой: сетевые
оккультизм: оккультизм
открытка: открытки
редактор: редактора
альфапласт: альфапласт
столовая: столовая
бокс: бокс
инвестирование: инвестирование
финансы: финансы
упаковка: упаковка
techno: techno
дайвинг: дайвинг
другой: другое
изобразительный: изобразительное
таэквон: таэквон
муза: муз
сиделка: сиделки сиделок
десерт: десерты
атомный: атомная
пк: пк
техобслуживание: техобслуживания
качество: качество
косметика: косметика
бесплатный: бесплатных
певица: певицы
музыкальный: музыкальные
курорт: курорты
чтение: чтение
прикол: приколы
байкер: байкеры
выборы: выборы
помощь: помощь
комплектующий: комплектующие
харьков: харьков
веб: веб
рубеж: рубежом
академия: академии
педагогика: педагогика
христианство: христианство
анализ: анализ
утилизация: утилизация
монета: монеты
заявка: заявка
расписание: расписания
скидка: скидки
язычество: язычество
центр: центр
субкультура: субкультуры
мультик: мультики
марка: марки
форекс: форекс
оценка: оценка
тест: тесты
