загар: загара
играть: играть играя
размер: размеров
ваш: вашего
билет: билет
серьезный: серьезная
частушка: частушки
снова: снова
ситуация: ситуации
мысль: мыслью
пенсионный: пенсионных пенсионные
цикорий: цикорий
платье: платья
личный: личное
быт: быт
такой: таком
молотый: молотый
связь: связь
добавлять: добавить
кризис: кризис
дом: дом дому
это: это
хобби: хобби
ребенок: ребенка детям детей дети ребенок
дух: дух
сайт: сайте
интересный: интересное
день: день
правильно: правильно
важно: важно
учитель: учителя
развивашка: развивашка
слово: слово
тело: тело теле
авиабилет: авиабилеты
красота: красота
балл: баллов баллы
проект: проекта проектам
вторичка: вторички
металлоконструкция: металлоконструкции
хороший: лучшая хороших
понимать: понимать
дорога: дорогу
средство: средство
здоровый: здоровый здоровом
популярный: популярен популярные
борьба: борьба
петь: пела
строить: строите строят
окно: окно
давать: дают
радиоуправляемый: радиоуправляемыми
статья: статьи статью
товар: товара
становиться: стать
еда: еда
находить: находить найти
источник: источником
проверять: проверенных
отдых: отдыха отдых
navigation: navigation
устанавливать: установят
купить: куплю
развиваться: развиваемся
собака: собак
видеть: видеть
развлечение: развлечением развлечения
коррекция: коррекция
дешевый: дешевые
ах: ах
рецепт: рецепты
недорого: недорого
древо: древу
пристальный: пристальным
пряник: пряники
тест: тест
домашний: домашнему
тонко: тонко
слыхать: слыхали
агентство: агентство
дома: дома
зрение: зрения
продукт: продукты
полноценный: полноценным
фазенда: фазенда
туризм: туризм
взрослый: взрослый взрослые
беременность: беременность
сшивать: сшить
грузоперевозка: грузоперевозки
тема: тема
попов: попов
этот: эта
практика: практика
клещ: клещи
дгк: дгк
выбор: выбор
мастер: мастеров
toggle: toggle
бывать: бывают
система: система
надежный: надежное
особенность: особенности
внимание: вниманием
модный: модная
защищать: защищены
налаживать: наладить
бросать: бросай
мочь: могут
посвящать: посвящен
мир: мир
курение: курением
объяснять: объясняет
отдыхать: отдыхаем
пора: пора
правильный: правильным правильные
полезный: полезны
самый: самые
человек: людей
растворимый: растворимый
пряничек: прянички
организованный: организованная
расчет: расчет
проблема: проблема
назначение: назначения
курить: курить
хозяйство: хозяйству
лазерный: лазерная
добывать: добыть
недвижимость: недвижимости
пиво: пиво
рольштора: рольшторы
сохранять: сохранить
почему: почему
школа: школу
интерьер: интерьер
блузка: блузку
жалюзи: жалюзи
игрушка: игрушками
делать: делать
возможно: возможно
мама: мама
деньги: деньги
нестандартный: нестандартных
утварь: утварь
зависимость: зависимости
здоровье: здоровье
лего: лего
бю: бю
родитель: родителей
кофе: кофе
конструктор: конструктор
какой: какими
новый: новые
выбирать: выбрать
экономический: экономический
право: права
германия: германии
папа: папа
свадьба: свадьба
раздел: раздел
который: которые
рад: рады
хозяин: хозяина
дмитрий: дмитрий
цель: целью
