возникать: возникающие
выставка: выставке выставка выставки выставку
e: e
онлайн: онлайн
монтажный: монтажные
конгресс: конгресс конгресса
цвк: цвк
компания: компанией компаний компании компания
журналист: журналистов
сжатый: сжатые
лицо: лиц
ю: ю
новинка: новинок
mail: mail
расположение: расположения
место: мест месте место
помогать: помогут
холодильный: холодильное
количество: количество
аккредитация: аккредитация
партнерский: партнерские
переговоры: переговоры
сибирский: сибирским
климатический: климатическую климатическая климатической
сезон: сезонов
эксперт: экспертов
создавать: создайте
видео: видео
исчерпывающий: исчерпывающие
контакт: контактов контакты
электронный: электронный
открытый: открыта
вызов: вызовы
экспоцентр: экспоцентр
инструмент: инструменты
заполнять: заполните
система: систем
регистрация: регистрация регистрацию
становиться: стать становятся
климат: климат климата
строить: строит
техника: техники
партнерство: партнерства
рекордный: рекордное
участник: участникам участником участниками участников участники
информационный: информационные
промышленный: промышленного промышленные
позволять: позволяет
технофрост: технофрост
заключать: заключайте
проходить: пройти
получать: получите получить
основной: основных основные
деловой: деловая
задача: задачи
главный: главные
элита: элиту
безопасность: безопасности безопасность
инжиниринговый: инжиниринговые
март: марта
маршрут: маршрут
спикер: спикеры
спектр: спектр
каталог: каталог
туристический: туристические
предложение: предложений
предприятие: предприятий предприятия
ежегодно: ежегодно
следующий: следующий
бизнес: бизнеса
мир: мир мира мире
нарабатывать: наработанных
посетитель: посетителям посетителей посетители
важный: важное
организатор: организаторы
евроэкспо: евроэкспо
выгодный: выгодные выгодных
проект: проект проекте
клиент: клиентов
ваш: вашей
обменяться: обменяетесь
составляться: составляется
пакет: пакет пакеты
лидер: лидеров
узнавать: узнаете узнать
решать: решают
продвижение: продвижения
бесплатно: бесплатно
отвечать: отвечает
открытие: открытия
который: которые который
тренд: трендами
бронирование: бронирование
россия: россии
ассоциация: ассоциация
форма: форму
атмосфера: атмосфере
expo: expo
площадка: площадке площадка
страна: стран
формировать: формируем формирует
связь: связи
world: world
аналитика: аналитика
euroexpo: euroexpo
проводить: проведете проводит
оборудование: оборудование оборудования
срок: сроки
первый: первых
отопление: отопления
отзыв: отзывы
свой: свой свои
мировой: мировой
climate: climate
бвм: бвм
гостиница: гостиниц
забывать: забудьте
дополнительный: дополнительные
личный: личные
крупный: крупнейший
руководство: руководством руководство
belluna: belluna
профессионал: профессионалов
уважаемый: уважаемые
следовать: следующих
cn: cn
участие: участия участие
год: году года год лет
covid: covid
кондиционирование: кондиционирования
прямо: прямо
мочь: могут
свое: свое
тот: тех
происходить: происходят
девелопмент: девелопмента
также: также
faq: faq
сопроводительный: сопроводительные
современный: современного
российский: российские
ответ: ответы
ru: ru
выставочный: выставочная
поиск: поиску
диалог: диалога
партна: партн
расписание: расписание
скоро: скоро
стенд: стендов
en: en
область: области
доступный: доступен
премьера: премьеры
специалист: специалистов
партнер: партнеры
сервисный: сервисные
объединять: объединяем
посещение: посещении посещения
вентиляция: вентиляции
компенсация: компенсации
дата: дата
холод: холода
схема: схема
автоматика: автоматика
пожелание: пожеланий
экспо: экспо
мера: меры
технический: техническое
бренд: бренда
присутствие: присутствие
заранее: заранее
полный: полный
список: список списком
рынок: рынка рынок
оставаться: осталось
новый: новых новейших новые
составлять: составить
подробный: подробные
программа: программа программы
r: r
посещать: посетили
промышленность: промышленности
обязательный: обязательным
проектный: проектные
импортозамещение: импортозамещение
представлять: представлены представляет
новость: новости
политика: политика
поставщик: поставщики поставщиков
событие: события
билет: билет билеты
раздел: разделы
ждать: ждем
время: время
экспозиция: экспозиции
ведущий: ведущие ведущих
прогноз: прогнозы
мероприятие: мероприятии мероприятий
спланировать: спланировать
архив: архив
контракт: контракты
считать: считают
накануне: накануне
индустрия: индустрия индустрии
коммерческий: коммерческого
предварительный: предварительная
коллега: коллеги
заказчик: заказчики
ры: ры
вопрос: вопросы
галерея: галерея
возможность: возможности
hvac: hvac
дело: делу
затрата: затрат
работа: работы
медиа: медиа
спонсор: спонсоры
влиять: влияет
маркетинговый: маркетинговые
стоять: стоят
цель: цели
какой: какие
зарубежный: зарубежные
фото: фото
находить: найдете
весь: весь
отрыть: отрытого
смотреть: смотреть
собирать: собирает
пропускать: пропустить
международный: международный
день: дни дня
дилер: дилеров
тенденция: тенденциях
рекламный: рекламные
отрасль: отрасли
подписываться: подпишитесь
февраль: февраля
сервис: сервисы
проведение: проведения
слово: слов
climat: climat
вход: вход
документ: документов
часто: часто
мороз: морозом
представитель: представителей
производитель: производители
встреча: встреч
учет: учетом
ознакомляться: ознакомиться
план: план
конфиденциальность: конфиденциальности
предлагать: предлагаем
преимущество: преимущества
условие: условия
зарабатывать: зарабатывать
апик: апик
указанный: указанный
реалистичный: реалистичные
карьера: карьеру
поддержание: поддержанию
москва: москва
опыт: опытом
общий: общие
ориентировать: ориентирована
заявка: заявка
центр: центр
