фишка: фишки
размещать: разместить размести
задавать: задать
входить: вошло
интернет: интернет интернетом
тесто: тесте
фейсбук: фейсбука фейсбук фейсбуке
подробно: подробнее
количество: количества
дата: дата
инструкция: инструкция инструкции
товар: товаре товарах
аудит: аудит
паблик: паблику
специально: специально
компания: компании компания
самостоятельно: самостоятельно
который: которая
информация: информация
это: это
раскрутка: раскрутке раскрутки раскрутка
сайт: сайте сайту
интересный: интересного интересное
социальный: социальных социальная
нанимать: нанятые
себя: собой
свой: своему своей
начинать: начала
разбирать: разберем
проводить: провести
главный: главная
мема: мемы
год: годы года год
сеть: сеть сети сетях
зарабатывать: заработать зарабатывает
видео: видео
прочее: прочее
новый: новых новые
поиск: поиска
появляться: появилась
подробный: подробные
статья: статей статьи статью
интерес: интерес
становиться: стала стали
связь: связей
профессионал: профессионалы
данный: данных
итог: итогом
файл: файл
автор: авторе
функция: функция
корпорация: корпорация
суммарный: суммарного суммарная
призыв: призыв
хорошо: получше
заработок: заработке заработка заработок
вперед: вперед
раздел: разделы
реклама: реклама
тест: тест
технология: технологий
неважно: неважно
купить: купить
обзор: обзор
предыдущий: предыдущие
настройка: настройки
заниматься: занимается
привлекать: привлечь
цель: цель
месяц: месяца
последний: последние
впечатление: впечатление
smm: smm
ведение: ведением
знак: знаком
получать: получить
внимание: внимание внимания
проходить: пройти пройди
прикольный: прикольные
этот: эта
аудитория: аудитории
регулярно: регулярно
картинка: картинки
развитие: развития
здание: здание
пользователь: пользователями
шикарный: шикарное
особенность: особенности
секрет: секреты
специальный: специальный
передача: передачи
складываться: складывается
отличаться: отличись
пост: постов
лайфхак: лайфхаках
группа: групп
обязательно: обязательно
сам: самого
вводить: введите
способ: способ способов
соц: соц
невероятный: невероятные
рассказывать: расскажем
каталог: каталог
просмотр: просмотр
мануал: мануалы
страница: страниц
взаимодействие: взаимодействий
нужный: нужен
сфера: сфере
владелец: владелец
лайка: лайки
парфюм: парфюмом
продвижение: продвижении продвижение
наш: наш
вопрос: вопрос
основание: основания
блог: блоге
факт: факты
немного: немного
необходимо: необходимо
загрузка: загрузка
находить: найти
предназначать: предназначена
мочь: могло
млрд: млрд
выручка: выручка
норма: норм
читать: читать
обо: обо
запрос: запрос
бизнес: бизнеса
метод: методов
сотрудник: сотрудники
заслуживать: заслуживает
усиление: усиление
работа: работу
слышать: слышал
пора: порой
сделать: сделать
feed: feed
каждый: каждый
деньги: деньги
совместный: совместный
подписчик: подписчиков
зависимость: зависимости
facebook: facebook
происходить: происходит
далее: далее
blog: blog
действие: действию
розыгрыш: розыгрыш розыгрыша
отключать: отключить
крупный: крупнейшая
общий: общий
отличный: отличный
позиция: позиций
мир: мире
представлять: представляет
проведение: проведение
повышать: повысить
топ: топ
