зловредный: зловредной
россия: россии
вирус: вирусами
подозрительный: подозрительными подозрительном
вводить: введенное введите введенные
рф: рф
форма: форму
доменный: доменное доменных доменный доменные доменном
аналитический: аналитические аналитический аналитическими
борьба: борьбы
онлайн: онлайн
сбор: сбора
первый: первый
домен: домена доменов доменах
фишинг: фишинг
это: это
сайт: сайт сайте
мы: нам нами
храниться: храниться
платформа: платформы платформу
вы: вами
ниже: ниже
обмениваться: обмениваются
заражать: заражающий
активность: активности
создание: созданием
вредоносный: вредоносный вредоносных вредоносными вредоносного
аналитика: аналитика
сервис: сервис
количество: количеству
ход: ходе
сотрудничество: сотрудничества
агрегация: агрегации
su: su
ресурс: ресурс ресурсами ресурсах ресурсе ресурса
год: году
проект: проекта проект проекте
обработка: обработки
проводить: проводят
сеть: сети
выбирать: выбрав выбранный
компания: компаний компаниями
участник: участниками участников участники
источник: источников
страница: странице страница
написать: написать
легенда: легенде
информационно: информационно
горячий: горячей
свой: свой
сообщать: сообщить сообщим сообщите
данный: данных
линия: линии
посвящать: посвященный
код: код
справочный: справочные
компьютер: компьютер
имя: имен имя имена именах
сообщение: сообщение
анализ: анализа анализ
формирование: формирование
считать: считаете
отображение: отображения
информационный: информационные информационной
проверка: проверке проверка
красть: крадущий
зафиксировать: зафиксированных
личный: личные
данные: данные данными
адресация: адресации
согласный: согласен
развивать: развивают
такой: такими
интеллектуальный: интеллектуальной
использовать: используемых использующий
уровень: уровням
научно: научно
политика: политикой
отчет: отчетов
любой: любой
персональный: персональных
координационный: координационного координационный
патруль: патруль
материал: материалы
безопасность: безопасности
скопировать: скопируйте
организация: организации
сведение: сведения
пространство: пространстве
зона: зонам
компетентный: компетентной
зловред: зловредов
свое: свое
botnet: botnet
заключение: заключение
исследовательский: исследовательскую исследовательской
информация: информации
интернет: интернет
начинать: начал
мочь: можете
тип: типам
противоправный: противоправной
связываться: свяжитесь
совместно: совместно
также: также
ряд: ряды
предупреждение: предупреждения
центр: центра центр
распространение: распространении распространение
сделать: сделают
период: период
который: которую
email: email
использование: использование
собственность: собственности
ru: ru
работа: работу
база: базе
размещение: размещения
график: график
категория: категориям
вид: видами
казаться: кажутся
вредоносность: вредоносности
публиковаться: публикуются
располагать: расположенную
веб: веб
посетитель: посетителям
подтверждать: подтверждаю
доступный: доступен
нетоскоп: нетоскоп
специалист: специалисты
технический: технического
связанный: связан
прирост: прирост
сконфигурировать: сконфигурировать
собственный: собственный
сразу: сразу
наш: нашей
посещать: посещаете
немой: нем
