свежий: свежие
предмет: предмета предметы
появляться: появился
e: e
снова: снова
рождение: рождения
школа: школа школы школ
онлайн: онлайн
простуда: простуды
фильм: фильмы фильмов фильма
экспедиция: экспедиции
готовить: готовят готовим
компания: компании
российский: российские российских
дом: дом
жилье: жилье
переезжать: переехать
ребенок: ребенка детьми детей дети ребенком ребенок
улучшать: улучшить
ю: ю
конкурс: конкурсы конкурс
характер: характер
детский: детский детских детской детскую детское
искать: ищу
русскоязычный: русскоязычных
запрещать: запрещена
mail: mail
важно: важно
поделиться: поделитесь
помогать: помогают помогут
музей: музее
книга: книга книг книги
работать: работают
эксперт: экспертов
отправлять: отправить
подросток: подросткам подростком подростков
игромания: игромания
ледокол: ледоколе
семья: семьей семья семьи семью семей
школьный: школьного
женщина: женщинами женщине женщин
зарегистрироваться: зарегистрироваться
мудрый: мудрая
выбирать: выбирать
трогать: трогай
телефонный: телефонный
внешность: внешности
мультсериал: мультсериалов
досуг: досуг
почта: почта
ошибка: ошибки ошибке
мечта: мечты
сообщать: сообщить сообщите
предназначать: предназначены
рожать: родила
распознавать: распознать
зритель: зрителей
ледниковый: ледникового
новорожденный: новорожденный
собака: собаки собаку собак
перемена: перемены
форма: форме
образовательный: образовательных
становиться: стать становятся
семейный: семейные семейным
стоять: стоит
клуб: клуб
америка: америка
отмечать: отметить
роды: роды родах
забавный: забавные
очень: очень
реклама: реклама
этномир: этномир
крокус: крокус
условие: условиях
детская: детская
день: день дней дня
группа: группа
творчество: творчества
развод: развод
запоминать: запомнить
заболеваемость: заболеваемость
ральф: ральф
спать: спать
обезопасить: обезопасить
материал: материалов материалы
выбор: выбор выбору
главный: главные
развитие: развития развитие
урок: уроки
зима: зимы зимой зима
фотоальбом: фотоальбомы
пожалуйста: пожалуйста
желание: желание
чаво: чаво
обратный: обратная
давать: давайте дайте
простой: простых
хота: хот
выпускник: выпускники
защищать: защищены защитить
договариваться: договориться
ежедневно: ежедневно
вундеркинд: вундеркинд
info: info
обувь: обувь обуви
опрос: опросы опрос
соцсеть: соцсети соцсетях
беременный: беременных беременной
заставлять: заставляют
интернет: интернета интернет
деньги: денег
setting: settings
бургер: бургеров
панно: панно
ya: ya
http: https
самый: самое самые самых
бесплодие: бесплодие
полезный: полезных
носить: носят
перепечатка: перепечатка
cтатьи: cтатьи
специалист: специалиста
дорогой: дороже
следующий: следующий
отдых: отдых
собирать: собрать
вкусный: вкусных
азия: азия
должный: должен
кино: кино
сегодня: сегодня
канал: канале
получаться: получилось
океанариум: океанариуме
подборка: подборка
вред: вред
запах: запах
шеф: шеф
африка: африка
делать: делать
влюбленный: влюбленных
мама: мама
право: права право
проект: проекты проект проекте
весь: всей
заметный: заметны
дополнительный: дополнительное
роман: роману романа
блюдо: блюд блюда
регистрационный: регистрационные
личность: личности
здоровье: здоровье
образование: образование образовании образования
память: памятью памяти
который: которых которые
аллергенный: аллергенны
расти: растет
согласие: согласия согласие
приготавливать: приготовить
популярный: популярных популярные
литература: литературе
родитель: родителей родителям
вещь: вещи
alp: alp
улицкая: улицкой
новое: нового
пара: пары
европа: европа
ру: ру
народ: народов
орлова: орлова
повар: повара
хотеть: хочу
рейтинг: рейтинги
геймификация: геймификация геймификации
внимание: внимание
быть: будут будь
новый: новый новую новом новых новые
всероссийский: всероссийский
неполадка: неполадки
поддержка: поддержкой
топ: топ
россия: россии россия
знание: знаний
тапочек: тапочки
высокий: высшее
фотография: фотографиями
готовый: готовая готовы
сыр: сыр
обсуждать: обсуждаемые
связь: связь
уговор: уговор
проблема: проблем проблемы
сезон: сезона сезоне сезону сезон
хобби: хобби
выпуск: выпуски
себя: собой
реалити: реалити
отдельный: отдельной
раздел: разделе
сорри: сорри
издатель: издателя
ортопедический: ортопедическая ортопедической
сервис: сервисы сервис
тема: темы тема темой
модный: модный модной
нейра: нейра
полюс: полюс
такой: такого
красота: красоты красота
www: www
знать: знать
ваш: ваши
брать: брал
планирование: планирование
микровязание: микровязание
первый: первых первые
покорять: покори
счетчик: счетчиков
старый: старше
домашний: домашними домашних
вестись: ведутся
северный: северный
вскармливание: вскармливание
высыпаться: высыпался
этнографический: этнографическом
сертификат: сертификат
подписывать: подписать
период: периода
обращать: обратить
драник: драники
сми: сми
вечеринка: вечеринке
данный: данных
похудение: похудение
другой: другие
грамотно: грамотно
болезнь: болезни
мосина: мосина
воспитание: воспитание
обучение: обучение обучения
коллекция: коллекции
динамика: динамику
широкий: широкая
разбираться: разобраться
зды: зды
кухня: кухне кухни
костомаров: костомарова костомарову
партнер: партнера
призыв: призыв
гармоничный: гармоничных
лечить: лечить
паста: паста
обнаруживать: обнаружили
подкаста: подкасты
тест: тест тесты
егэ: егэ
купить: купить
данные: данные
сад: садов
пособие: пособия
учеба: учебе
мультфильм: мультфильмы
все: всеми
change: change
женский: женское женская
чудо: чудо
здоровый: здоровая здоровый здоровое
персональный: персональных
порода: породы
видеоигра: видеоигры
год: года год лет
участие: участия
признак: признаки
тематический: тематические
конференция: конференции
логин: логин
мать: матери
жизнь: жизни жизнь
занятие: занятия
sia: sia
поговорить: поговорить
план: планы
корешок: корешки
квартира: квартиру
грудной: грудное
подростковый: подростковый
жареный: жареный
тело: тела
зависимость: зависимость зависимости
путешественник: путешественникам
понимать: понять
метод: метод
нка: нка
игровой: игровой
парк: парке
mailru: mailru
блинный: блинный
бесконечно: бесконечно
изображать: изображенные
ru: ru
работа: работы работа работу
путешествие: путешествия
сайт: сайта сайт сайте
взять: возьмут
шоу: шоу
премьера: премьеры
возраст: возраст
пятерочка: пятерочки
нежный: нежная нежных
свой: своей свои
дача: дачу дача
муж: мужья муж
досрочный: досрочный
тропический: тропических
реб: реб
ольга: ольга
психология: психология
товар: товары
практика: практик
забота: забота
bchen: bchen
дачный: дачному
долгожитель: долгожителей
гендерство: гендерство
род: родам родов
ощущение: ощущение
автор: авторов
карьера: карьера
время: времен
это: это
бережливый: бережливый
неделя: недели
беременность: беременности беременность
поддерживать: поддержат
навевать: навеяло
продукция: продукцией
григорий: григория
бензин: бензин
чарльз: чарльз
особый: особые
обработка: обработки
прекрасный: прекрасное
драйв: драйв
долг: долги
пример: примере
зв: зв
посмотреть: посмотреть
практик: практики
потеря: потерь
сдавать: сдавать
развлечение: развлечений
проводиться: проводятся
написать: написанные
редакция: редакции
проходить: пройдите прошла
актуальный: актуальное
болеть: болит
еда: еда
рассказ: рассказы
животный: животных
студент: студента
россиянин: россияне
мы: нам
рецепт: рецепты рецепта
сообщение: сообщение
спецпроект: спецпроекты
деринат: деринат
совпадать: совпадать
политика: политика
медицина: медицина
кровь: крови
король: король
сити: сити
собственный: собственного
выходной: выходные
лекция: лекции
вальгус: вальгус
игра: игр
архангельский: архангельском
вирус: вирусов
оплачивать: оплатить
перерасти: перерастет
дело: делами
весенний: весенний
мотивация: мотивацией
против: против
жить: живут живи
поделка: поделки
экскурсия: экскурсии
вконтакте: вконтакте
картинка: картинки
жена: жен
масленица: масленицу масленица
отношение: отношений отношения
диета: диеты
дачник: дачников
многообразие: многообразии
информационный: информационный
кулинарный: кулинарная
давно: давно
предыдущий: предыдущий
распределяться: распределяются
аутизм: аутизм аутизма
увидеть: увидеть
кошка: кошек кошку
освоение: освоение
пароль: пароль
садовод: садоводов
любимый: любимые
присылать: присылайте
нные: нных
вопрос: вопрос вопросам
наш: наш
счастие: счастья
дочка: дочку
нейросеть: нейросетью
два: две
возникать: возникает
вместе: вместе
напоминать: напомнить
любовь: любовь
экологичный: экологично
фестиваль: фестиваль
указывать: укажите
ухудшение: ухудшения
польза: польза
людмила: людмилы
калейдоскоп: калейдоскоп
сколько: сколько
школьник: школьнику школьника
творог: творога
приз: призы
кормить: кормить кормящая
сериал: сериалов сериалы
часть: часть
быстрый: быстрое
город: города
исправлять: исправить
публиковаться: публикуются
усыновление: усыновление
шашка: шашек
viber: viber
рукоделие: рукоделию рукоделие
круг: кругу
фигурист: фигуристу фигуристы
активный: активный
парикмахер: парикмахера
ехать: еду
суждение: суждений
домоводство: домоводство
блог: блоги
питание: питание
узнавать: узнаете
нок: нок
квест: квест
акция: акции
ждать: ждут
фабрика: фабрике
писательница: писательниц
правильно: правильно
необычный: необычных
супруг: супругами
какой: какие
московский: московская
образ: образ
безопасный: безопасная
взрослый: взрослых
одар: одар
интеллектуальный: интеллектуальный
след: след
джанеллы: джанелл
смартфон: смартфона
дмс: дмс
telegram: telegram
режим: режим
vk: vk
место: мест
прививка: прививок
одноклассник: одноклассниках
влиять: влияют
летний: летняя
дырявый: дырявом
смотреть: смотреть
мужчина: мужчина
medium: media
пропускать: пропустить
москва: москве
осень: осень
е: е
рано: раньше
joonies: joonies
privacy: privacy
подарок: подарки
мнение: мнениями мнение
далеко: далеко
дома: дома
допускать: допустить
махеев: махеевъ
подсказка: подсказок
спасибо: спасибо
играть: играют
праздничный: праздничных
организовывать: организовать
пригождаться: пригодятся
момент: моментов
вход: вход
авторский: авторские
приготовление: приготовления
неприятный: неприятный
ok: ok
страница: странице
pinterest: pinterest
регистрация: регистрации
актуально: актуально
вершок: вершки
статья: статьи
булочка: булочки
url: url
секрет: секреты
праздник: праздники
рука: руки
мир: мир
инфекция: инфекций
поиск: поиск
аллергия: аллергия
лес: лесов
воскресный: воскресная
нижний: нижним
подготовка: подготовка
свидетельство: свидетельство
целый: целый
irenar: irenar
использование: использовании
сказка: сказка сказке
находить: найти
преимущество: преимущества
нужно: нужно
новогодний: новогоднее
имущество: имущества
наименее: наименее
правило: правил
финансы: финансы
английский: английском
совет: советов
неточность: неточности
дошкольный: дошкольного
заболевание: заболевания
минута: минут
почему: почему
госуслуга: госуслугах
цель: целей
победитель: победителям
патриотический: патриотическое
чтение: чтение
носок: носке
посоветуйт: посоветуйт
помощь: помощь
дог: догов
вмешиваться: вмешаться
любитель: любителям
оставаться: остались
оценочный: оценочных
календарь: календарь
житель: жители
питомец: питомцы
b: b
письменный: письменного
армия: армию
