два: двух
телфин: телфин
e: e
течение: течении
office: office
обычно: обычно
андрей: андрей
евгений: евгений
входить: входящих входящий входящие войти
компания: компании компания
конференция: конференция конференций
дом: дом
рекомендовать: рекомендуемые рекомендуем
отправлять: отправьте отправить отправлено отправлена
конкурс: конкурс
mail: mail
показывать: показать покажет
место: мест место
деятель: деятели
важно: важно
телеком: телеком
вызов: вызовов вызова вызовы вызов
единый: единой
ватс: ватс
форум: форум форума
проводить: проведен провести
crm: crm
ход: ходе
количество: количество
далеко: дальше
левыкин: левыкин
малый: малого малый
лицо: лицо
пользователь: пользователя пользователей
ответственный: ответственных
публичный: публичный
заявка: заявки заявка
вчера: вчера
корректный: корректный
новый: новый новая
открываться: открывается
почта: почта
мегаплан: мегаплан
старый: старым старый
характеристика: характеристики
председатель: председатель
хороший: лучших лучшие
аккаунт: аккаунта аккаунт
стоять: стоит
sip: sip
изменень: измененями
якутия: якутия
очень: очень
позволять: позволяет
сrm: сrm
личный: личный
тело: тел
транк: транк
рейтинг: рейтинг
удаваться: удалось
красивый: красивые
запоминать: запомнить
получать: получите получить
задача: задачи
выбор: выбор
объем: объем
фрилансер: фрилансер
безопасность: безопасности
очередь: очередь
фоновый: фоновая фоновую
давать: дать
открытый: открытое
система: систему система системой
пожалуйста: пожалуйста
самый: самое самом
dsl: dsl
вводить: ввели введите
решение: решение решений
реализация: реализации
номер: номера номеров номер
интернет: интернета интернет
сеть: сеть сети
международный: международном международная
договор: договор
специалист: специалиста
amocrm: amocrm
оперативно: оперативно
название: название
читать: читать
бизнес: бизнеса бизнес
соглашение: соглашения
email: email
должный: должны должен
изменение: изменение
позвонить: позвоните позвонить
готовый: готовых
звуковой: звуковому
нужный: нужен нужны нужна
тип: тип
тарификация: тарификация
фирменный: фирменного
выгодный: выгодные выгодное
вебирит: вебирите
диктор: диктора
написать: напишите написать
крупный: крупного крупнейшие
голосовой: голосовое голосовая
страна: страна
обзор: обзоры обзор
тариф: тарифа тарифы тариф тарифов
задумываться: задумался
удержание: удержании удержание
мойсклад: мойсклад
pdf: pdf
узнавать: узнать
автоматически: автоматически
подключать: подключать
новое: нового
хотеть: хотите
бесплатно: бесплатно
ваш: ваше ваша ваши ваш
спутниковый: спутниковой спутниковых
топ: топ
оператор: операторов операторам операторы
параметр: параметрам
телефония: телефонии телефонию телефония
шаг: шагах шаг
одновременный: одновременных
кабинет: кабинет
мелодия: мелодию мелодия
связь: связь связи
быстро: быстро
несколько: нескольких
вы: вами
выступать: выступил
поддерживать: поддержали
раздел: раздел разделе
старое: старое
russia: russia
пропустить: пропущенных пропущенным
сервис: сервис
www: www
комментарий: комментарии комментарий
провайдер: провайдера провайдеры провайдеров провайдерам провайдеру
текст: текст
оборудование: оборудование
эконом: эконом
версия: версии
минимум: минимум
руб: руб
клиент: клиента
отзыв: отзывы
пожелание: пожелания
предложение: предложения предложение
ростелеком: ростелеком
петербург: петербург
отображать: отображает отобразит
успешно: успешно
такой: такое
dial: dial
принимать: принято
свой: своего свой
данный: данных данным
другой: другие
факс: факс факса
секунда: секунд
соединение: соединений
корпорация: корпорация
контактный: контактным
виртуальный: виртуальный виртуальной виртуальная виртуальные
икт: икт
транкинг: транкинг
дополнительный: дополнительные
выбирать: выберите
управлять: управляйте
содержать: содержать
стац: стац
home: home
пао: пао
производство: производства
оставлять: оставить
посекундный: посекундная
ringcloud: ringcloud
satellite: satellite
логин: логин
yes: yes
месяц: месяца месяц
премиум: премиум
портал: портале
главный: главную главный
ока: ок
организация: организация
terrasoft: terrasoft
допускать: допустим
кнопка: кнопку
служба: служба
республика: республики
faq: faq
федеральный: федеральный
новосибирск: новосибирск
предназначать: предназначена
siplinkpro: siplinkpro
api: api
контролировать: контролировать
услуга: услуге услуги услугу
переходить: перейти
архангельск: архангельск
ru: ru
апрель: апреля
цена: цене
меню: меню
указывать: укажите указать
закрывать: закрыть
примерный: примерный
сайт: сайта сайте
конференц: конференц
снг: снг
вэф: вэф
акция: акции акция
файл: файлу
телефон: телефонов телефона телефон
назад: назад
моб: моб
область: области
caller: caller
требование: требования
формат: формате
направлять: направьте
заданный: заданным
добавлять: добавлена
правительство: правительства
планировать: планирует
саратов: саратов
конец: конце
изменять: изменить
cообщение: cообщение
вести: ведите
мой: мое
высоко: выше
пропуск: пропуск
сделать: сделали сделать
подписывать: подписали
филиал: филиала
правый: прав
число: число
срочно: срочно
платеж: платежи
состоять: состоять
это: это
час: часов
екатеринбург: екатеринбург
опция: опция опции
прием: прием
нью: нью
продолжать: продолжает
город: город
полный: полный
указанный: указанным
проект: проекта
неверный: неверный
клик: клик
линия: линия
список: список
юр: юр
я: мною
отечественный: отечественного
westcall: westcall
интеграция: интеграция интеграций
персональный: персональные
один: одну одному
план: планах
пропускать: пропущенные
бесплатный: бесплатный
мегафон: мегафона
переадресовывать: переадресовывать
приветствие: приветствие приветствия
ivr: ivr
сообщение: сообщение
авторизация: авторизация
новость: новости
совпадать: совпадать
модуль: модуль
старт: старте старт
символ: символов
рекламный: рекламное
наличие: наличие
настроение: настроением
блокировка: блокировка
согласный: согласен
запись: запись
здорово: здорово
работать: работает работало
экономический: экономического
документ: документе документ
статистика: статистика
генеральный: генеральным
оформление: оформление
внедрение: внедрению
саха: саха
расширять: расширять
забывать: забыли
партнер: партнером
национальный: национальный
разговор: разговоров
физ: физ
цифра: цифру
пароль: паролем пароля пароль
переадресация: переадресация
сумма: сумма
городской: городских городской городского
звонить: звонить
связываться: связались
восточный: восточного
регистрация: регистрация
россия: россия
ii: ii
соответствие: соответствие
дальневосточный: дальневосточного
сколько: сколько
сравнивать: сравнить
сохранять: сохранить
lte: lte
использовать: использовать используя
краснодар: краснодар
программный: программное
офис: офис офиса
повтор: повтор
средний: среднего
платный: платные
copyright: copyright
помогать: помогает
зависимость: зависимости
далее: далее
звучать: звучало
минимальный: минимальные
партнерский: партнерскую
приветсвие: приветсвие
отличный: отличный
украина: украина
отмечаться: отмечается
вопрос: вопросы
многоканальность: многоканальность
восстановление: восстановление
цель: целью цели
команда: команда
обеспечение: обеспечение
работа: работы
совершенно: совершенно
являться: является
консультация: консультацию
мес: мес
подключение: подключение подключения
заказ: заказа заказ
госзакупки: госзакупок
баннер: баннер
просматривать: просмотреть
контроль: контроль
сегмент: сегментов
звонок: звонка звонки звонков звонок
чекин: чекин
контакт: контакты
июль: июля
зарегистрироваться: зарегистрируйтeсь
подбирать: подобрано подобрать
воспользоваться: воспользовались
свяжуться: свяжуться
sm: sms
ci: cis
москва: москва москве
исходить: исходящих
согласие: согласие
все: всем
дома: дома
выделять: выделенная
смочь: сможете
передача: передаче
спасибо: спасибо
казань: казань
рабочий: рабочих
журнал: журнал
поддержка: поддержки
ожидать: ожидайте
форма: формой
политика: политики
отвечать: ответит
внедрять: внедрить
id: id
хотя: хотя
владивосток: владивостоке
статья: статьи
атс: атс
сотрудник: сотрудник
voipobzor: voipobzor
ip: ip
беларусь: беларусь
размещение: размещение
вариант: вариантов
битрикс: битрикс
находить: найти
компьютер: компьютера
оферта: оферты
требоваться: требуется
нужно: нужно
запрос: запрос
автоперезвон: автоперезвон
буква: букву
администрация: администрацию
сравнительный: сравнительный
фио: фио
имя: имя
потребность: потребности
интересовать: интересует
voip: voip
приветсвия: приветсвия
попробовать: попробуйте
мудрый: мудрое
анализ: анализ
поминутный: поминутная
сразу: сразу
g: g
директор: директор
нажимать: нажмите
b: b
тематический: тематический
telphin: telphin
среди: среди
