нажимать: нажимая нажмите
ваш: вашего ваши вашей вашу
поддерживать: поддержать поддерживаем
e: e
подробно: подробнее
снова: снова
офтальмолог: офтальмолог
челябинский: челябинская
sozidanie: sozidanie
специалист: специалист
который: которая
авторизоваться: авторизоваться
поле: поле
телефон: телефону
отправлять: отправить отправив отправлено отправлена
социальный: социальных
mail: mail
поделиться: поделитесь
пожертвование: пожертвованием пожертвование пожертвования пожертвований
главный: главная главную главный
правило: правилами
последний: последний
отправка: отправке
зарегистрироваться: зарегистрироваться
пример: пример
фонд: фонду фонде фонд фонда
детский: детский
ssl: ssl
регистрация: регистрация регистрации регистрацию
налево: налево
связываться: свяжемся
редкий: редким
белов: белова
условие: условиях
врач: врачей врач
настройка: настройки
личный: личный
нейрохирург: нейрохирург
ребенок: детей
благотворитель: благотворителей
партнер: партнеры партнер
билайн: билайн
направление: направления
получать: получить
net: net
стоп: стоп
тимошин: тимошина
кодовый: кодовое кодовым
хотеть: хочет
пожалуйста: пожалуйста
валерий: валерий
сообщение: сообщения сообщении сообщение
авторизироваться: авторизируйтесь
защищать: защищены
info: info
почитать: почту
параметр: параметры
сеть: сеть сетях
мочь: можем можете
договор: договор
доступный: доступна
решать: решили
дополнительный: дополнительная
сегодня: сегодня
ул: ул
ирина: ирина
данные: данные данными
категория: категорию категории категориям
дарить: дарит
соглашение: соглашение
каждый: каждый
весь: всей
коммисия: коммисия
миссия: миссия
меропритяие: меропритяие
европа: европа
программа: программы программ программу
mixplat: mixplat
новогиреево: новогиреево
остановка: остановки
сч: сч
россия: россии
магнитогорский: магнитогорская
ежемесячный: ежемесячной ежемесячное
мобильный: мобильный мобильного
зарегистрировать: зарегистрированы
принимать: принимаете принять
кабинет: кабинет
павленко: павленко
ответный: ответного
выходить: выйти
вы: вами
новый: новый
совет: совет
просто: просто
благодарить: благодарим
координатор: координатор
руб: руб
выход: выход
доверие: доверие
должный: должны
сотня: сотни
успешно: успешно
информация: информацию информация
возврат: возврата
другой: другая
сертификат: сертификатом
сервис: сервиса сервисом
подтвердить: подтвердите
данный: данных данная данное
плюс: плюс плюсом
г: г
андреевич: андреевич
анна: анна
выбирать: выбрать выберите
почта: почте
радость: радость
дарение: дарения
применять: применены
дождаться: дождитесь
персональный: персональных
платеж: платеж
aniridia: aniridia
месяц: месяц
близкий: ближайшее
эндокринолог: эндокринолог
лимит: лимиты
разный: разным разные
мтс: мтс
оказывать: оказывать
тот: тех теми та
тепло: тепло
кнопка: кнопку
страница: страницы страницей
чармосов: чармосова
повторно: повторно
центр: центра
ru: ru
паспорт: паспорт
закрывать: закрыть
сайт: сайта
турникет: турникетов
политика: политику политикой
услуга: услуг услуга
национальность: национальности
пользователь: пользователь
оферта: оферты оферта
обратитесть: обратитесть
участие: участие
асадов: асадов
проходить: прошел
бухгалтер: бухгалтер
вероисповедание: вероисповедания
списываться: спишется
пожертвовать: пожертвовать
данна: данной
генетик: генетик
мобайл: мобайл
иметь: иметь
комитет: комитета
кмн: кмн
помогать: помочь поможете помогать
обработка: обработки
неверный: неверный
отчет: отчеты
первомайский: первомайская
ссылка: ссылка
одноклассник: одноклассники
благотворительный: благотворительный
пт: пт
наш: наш нашей наша
cost: cost
созидание: созидание
автобус: автобусы
электронный: электронную
жиганшин: жиганшина
новость: новости
представитель: представитель
тинькофф: тинькофф
д: д
медицина: медицина
администратор: администратору
онколог: онколог
время: время
такой: такими
оказание: оказания
низамиевич: низамиевич
записывать: записан
медицинский: медицинских
bf: bf
наука: наук
заболевание: заболеваниям
вконтакте: вконтакте
екатерина: екатерина
забывать: забыли
транзакция: транзакции
поддержка: поддержку
соглашаться: соглашаетесь
образование: образование
сброс: сброс сброса
лилия: лилия
пароль: пароля пароль
support: support
помощь: помощи помощь
метро: метро
пн: пн
герой: герой
сумма: сумму суммой сумма
вадим: вадим
вместе: вместе
улица: улицу
разовый: разовое
номер: номер
указывать: укажите
профиль: профиля
руслан: руслан
мегафон: мегафон
деньги: деньги
письмо: письмо
устанавливать: установите
благотворительныйфонд: благотворительныйфонд
член: член
педиатр: педиатр
восстановление: восстановления восстановление
скопировать: скопирован
команда: команда
работа: работы
заполнение: заполнения
меропритие: меропритие
михайлов: михайлова
пользование: пользовании
офтальмохирург: офтальмохирург
сделать: сделайте сделать
офис: офис
первый: первый
семья: семья
деталь: деталей
пока: пока
научный: научного
составлять: составлять составим
позволять: позволяют
подтверждение: подтверждение подтверждения
взрослый: взрослых
слово: слово
тело: теле
соединять: соединяем
тарасова: тарасова
вагон: вагон
кандидат: кандидат
сбор: сбор
смотреть: смотреть
sm: sms
технический: технический
отписываться: отписаться
наталья: наталья
валерьевич: валерьевич
сараев: сараева
михайловна: михайловна
доктор: доктор
вводить: ввели
словом: словом
подтверждать: подтвердить
спасибо: спасибо
организовывать: организовать
александровна: александровна
подписка: подписки
фандрайзер: фандрайзер
вход: вход
уточнение: уточнения
yota: yota
короткий: короткий
лобанова: лобанова
обязательно: обязательно
юлия: юлия
соц: соц
местожительство: местожительства
человек: людей
независимо: независимо
нужно: нужно
входить: войти
пользовательский: пользовательское
порядок: порядке
нуждающийся: нуждающихся
пять: пять
сотрудник: сотрудники
мария: мария
указанный: указанный
нуждаться: нуждается
волонтер: волонтер
москва: москва
смирнов: смирнова
попробовать: попробуйте
восстанавливать: восстановить
заявка: заявка
бондарь: бондарь
открывать: откройте
елена: елена
ошибка: ошибка
директор: директор
аниридий: аниридия
