свежий: свежие
страна: стране странах
ваш: вашего вашей вашим
соответствовать: соответствует
обычно: обычно
подробно: подробнее подробно
продукт: продукта продукты
цена: цена ценам ценами
верхний: верхние
онлайн: онлайн
вывод: выводы выводов
клиент: клиентах
компания: компании
именно: именно
вид: вид
запрещать: запрещено
помогать: помогут помогаем помочь
psiphon: psiphon
безопасный: безопаснее безопасный безопасного
главный: главная главных
количество: количество количества
специалист: специалистами
требовать: требует
иметь: имеющие
эксперт: эксперты экспертов экспертами
основывать: основанных
приобретать: приобретать
статья: статья статьях
раскрывать: раскрывала
наш: нашем нашими наших наша нашей наши нашим
пользователь: пользователь пользователя пользователей
выбирать: выбрать выберите выбирать
расход: расхода
оптимальный: оптимальный оптимальны
срок: срок
приводить: приведет
какой: каком
один: одним одном
рассматриваться: рассматривается
лицо: лицам
многие: многие
запрос: запросы
характеристика: характеристики характеристиками характеристиках характеристикам характеристик
использовать: используемого использовать
хороший: лучшей лучшие лучший
надежный: надежного
детальный: детальная детальные
стоять: стоит
каждый: каждого каждая каждом каждый
определенный: определенных
современный: современный
обрыв: обрыва обрыв обрыве
нахождение: нахождении нахождения
позволять: позволяют позволяет
базовый: базовых
сомнительный: сомнительную
условие: условиях
день: дней
лого: лого
сведение: сведений
рейтинг: рейтингов рейтинг рейтинге рейтинга
небезопасный: небезопасные
необходимый: необходимым необходимые
загрузка: загрузки
отсутствие: отсутствии
польза: пользу
выбор: выбор выборе выбора
подборка: подборку
технический: техническими технических
сомнение: сомнений
благодаря: благодаря
цель: целям
задача: задач задачи задача
безопасность: безопасности безопасность
решаться: решаются
свободный: свободного
оформлять: оформлены
передача: передаче передачи
средство: средств средства
подходящий: подходящий
касаться: касаются
решение: решение решений
предложение: предложении предложений
журнал: журнал журналы
интернет: интернете интернет
деньги: денег
обзор: обзоры обзорах обзорам обзоре обзор
сеть: сеть сети
diam: diam
давать: дадим
определять: определить
строка: строки
virtual: virtual
вносить: вносят
nonummy: nonummy
вложение: вложений
понимать: понимаем понять
исходить: исходя
выход: выходом
лишний: лишних
euismod: euismod
андроид: андроид
данные: данные данными
сервис: сервису сервисы сервисов сервиса сервис сервисами
nibh: nibh
действие: действия действий
представлять: представленных представленные представлена
тип: тип
высокий: высокие высокими
трата: тратой
параметр: параметрами параметрам
популярный: популярного популярные
протестировать: протестированы
практический: практическую
сам: сами
автоматически: автоматически
помощь: помощью
законный: законно
местоположение: местоположение
тщательный: тщательным
стоимость: стоимость стоимости
aes: aes
сообщать: сообщают
elit: elit
совершать: совершать
непосредственно: непосредственно
гарантийный: гарантийный
игра: игры игр
оценка: оценками оценку оценка
соединение: соединений соединения
skip: skip
доступ: доступа доступы
доступность: доступность
аспект: аспекты
то: тому
легитимность: легитимности
fi: fi
недоступный: недоступные
dolore: dolore
связь: связи
просто: просто
network: network
пропускной: пропускные
личный: личных личную
гибкий: гибкими
блокировка: блокировке
территориальный: территориальные
cyberghost: cyberghost
стриминг: стриминга
стремиться: стремимся
отзыв: отзывы
возврат: возврата возврат
информация: информацию информации информация
применение: применения
принимать: принято
обращать: обратить
свой: своих своей свой свои
private: private
данный: данных
блокировать: блокировать
случай: случае
контент: контент
предлагать: предлагает предлагают
другой: другие других
потоков: потоковым
оказываться: оказаться оказывается
ipvanish: ipvanish
важный: важные важной
несколько: несколько несколькими
перечень: перечнем перечне
erat: erat
виртуальный: виртуальная
переплачивать: переплачивать
шифрование: шифрования
дополнительный: дополнительные
большинство: большинство
различный: различных
технология: технологии
nordvpn: nordvpn
подбор: подбору
возможность: возможности возможность возможностями возможностей
любой: любые любой
устанавливать: устанавливают
персональный: персональных персональные
набор: набор
считаться: считается
большой: большого
тестирование: тестирование
владеть: владеющие
критерий: критериев критерии
зависеть: зависит
камень: камни
обмен: обмена
интересовать: интересующие
недружественный: недружественной
мочь: могут
sed: sed
удаленность: удаленность
социальный: социальные
нужный: нужен
скачивание: скачивания
рынок: рынке
такой: таким такую
навык: навыков
логирование: логирования
автоматический: автоматическая
faq: faq
сопровождаться: сопровождается
спрос: спросом
adipiscing: adipiscing
несоответствие: несоответствия
ответ: ответы
денежный: денежных
переходить: перейти
процесс: процессы
ожидание: ожиданиям
изучение: изучением
использование: использование использовании
ru: ru
репутация: репутацию репутация
закон: законом
пункт: пунктов
content: content
специфика: специфике
никто: никто
адрес: адреса адрес
спортивный: спортивных
доверять: доверяют
наличие: наличии
защита: защиты защита
основа: основе
доступный: доступных
стандарт: стандартам
стриминговый: стриминговый
мир: мире
сеанс: сеанса
посещать: посещать
играть: играть
тестировать: тестировать
некоторые: некоторые
sit: sit
пакетный: пакетных
самый: самых самыми
скорость: скоростями скорость
всесторонний: всестороннее
wi: wi
это: это
опция: опция опции
сторонний: сторонним
сочетать: сочетают
протокол: протокола
значит: значит
internet: internet
iphone: iphone
webrtc: webrtc
сайт: сайт сайте
призывать: призвана
например: например
пустой: пустой
посмотреть: посмотреть
новый: новых
подробный: подробные
уверенный: уверенными
нарастать: нарастающего
expressvpn: expressvpn
замечать: замечен
программа: программы
справляться: справятся
netflix: netflix
снижение: снижения
корректив: коррективы
сервер: сервером серверов
составлять: составили
останавливаться: останавливаться
событие: событий
разрешать: разрешенных
услуга: услуги
ipsum: ipsum
серфинг: серфинг
мы: нам
своевременно: своевременно
ответственность: ответственности ответственностью
подходить: подходят
функция: функций функции
утечка: утечке утечек
amet: amet
приватность: приватности
время: время времени
разный: разных разные
способ: способах
проверка: проверку
предоставлять: предоставляют
разблокировка: разблокировки
правило: правила
степень: степень
число: числе
предъявляться: предъявляется
платежный: платежных
подводный: подводные
требование: требований
официально: официально
dns: dns
разрабатывать: разработали разрабатывают
геополитический: геополитические
aliquam: aliquam
закономерный: закономерно
ко: ко
просматривать: просматривать
собирать: собирают
увидеть: увидеть
tunnelbear: tunnelbear
рассказывать: расскажем
конкретный: конкретных
следить: следят следить
лог: логи
целое: целом
заблокировать: заблокировать
вопрос: вопросы вопрос
выражаться: выражаться
провайдер: провайдер провайдеры
этот: этих
фильм: фильмов
обо: обо
торрент: торренты торрентах
поиск: поиске
access: access
система: систему
узнавать: узнает
сохранять: сохранить
удаленный: удаленным
оба: обе
switch: switch
обеспечиваться: обеспечивается
инструмент: инструмент
copyright: copyright
происходить: происходит
практика: практике
факт: фактах
впн: впн
обязанность: обязанность
актуальный: актуальных
никакой: никакой
ограничение: ограничениями ограничения
работа: работы
который: которым
насколько: насколько
площадка: площадкам
вариант: варианты варианта
ut: ut
файл: файлами
грозить: грозит
мера: мере
трансляция: трансляциями
профессиональный: профессиональную
самостоятельно: самостоятельно
платформа: платформам
сериал: сериалов
оценивать: оценить
подключение: подключение
consectetuer: consectetuer
покупка: покупки
процент: процент
выходить: выходить
активность: активности
volutpat: volutpat
пользоваться: пользоваться
полный: полной
мошенничество: мошенничества
качество: качеству
приложение: приложения
проводить: проведенное проводят
показатель: показатели
находить: найдете
подбирать: подберете подобрать
категория: категории
способность: способность способности
задавать: задаваемых задаваемые
выгодный: выгодным
отслеживать: отследить
причина: причине
украсть: украсть
возможный: возможен
kill: kill
ситуация: ситуациях
приватный: приватная
далеко: далеко
все: всем
ресурс: ресурсов
трафик: трафика
комфортный: комфортный
конфиденциально: конфиденциально
смочь: сможете
третий: третьим
они: ними
особенность: особенностях
мнение: мнения
плохой: плохими
изменение: изменения
бесплатный: бесплатные
политика: политики
laoreet: laoreet
адекватность: адекватности
часто: часто
обеспечивать: обеспечивать
обмениваться: обмениваться
решать: решает
dolor: dolor
hidemyass: hidemyass
предупреждать: предупредим
vpn: vpn
ip: ip
вести: ведут
повод: поводу
пространство: пространстве
сэкономить: сэкономить
приносить: приносила
ipv: ipv
снижаться: снижается
подмена: подмену
ознакомляться: ознакомиться
конфиденциальность: конфиденциальности
качественный: качественного
magna: magna
соответствие: соответствии
privatevpn: privatevpn
обзорный: обзорных
преимущество: преимущества
нужно: нужно
встречаться: встречаются
почему: почему
просмотр: просмотра
freeproxy: freeproxy
версия: версий
возлагать: возложена
tincidunt: tincidunt
пк: пк
фактор: факторов
посещение: посещение
деталь: детали
очевидно: очевидно
lorem: lorem
защищенность: защищенности
surfshark: surfshark
основной: основными
программный: программных
ошибка: ошибка
становиться: стал
среди: среди
