обслуживаться: обслуживаться
василий: василий
петровский: петровская
смс: смс
опорный: опорно
room: room
забота: забота
кибернетик: кибернетики
доступный: доступная доступны
большой: наибольшую
пожертвование: пожертвование пожертвования
добро: добро
население: населения
необходимость: необходимости
подробно: подробнее
sa: sa
социально: социально
первый: первый первой
волонтерство: волонтерство
собирать: собрано
попечительство: попечительство
это: это
социальный: социальной
взяться: взяться
ребенок: детей дети детям
воскресный: воскресной
смочь: сможем
различный: различные
очередь: очереди
инвалид: инвалиды инвалидам инвалидов
пробовать: пробуют
потребность: потребность
ростовский: ростовская ростовской
пожертвовать: пожертвовать
мужчина: мужчины
popechitelstvo: popechitelstvo
фото: фото
взрослый: взрослых
таганрог: таганрог таганроге
главный: главная
воспитывать: воспитывает
год: году
например: например
отчет: отчеты
любой: любую
область: область области
голубев: голубев
одноклассник: одноклассники
видео: видео
испытывать: испытывают
благотворительный: благотворительная благотворительные
контакт: контакты
наш: наши нашем
июль: июля
поддерживать: поддерживает
аппарат: аппарата
фонд: фонде фонд фонда
адаптивный: адаптивной
программа: программа программ программы
работать: работает
предложение: предложения
enter: enter
кандинский: кандинском
л: л
смотреть: смотреть
физкультура: физкультуры
двигательный: двигательного
подтвердить: подтвердите
делать: делаем делать
необходимый: необходимое
познавать: познают
навигация: навигация
ограниченный: ограниченными
основной: основной основная основные
г: г
начинать: начать
телефон: телефоны
текст: текстом
новость: новости
решать: решая
существо: существа
событие: события
приходить: пришла
моргунов: моргунов
apple: apple
все: всем
н: н
детская: детская
разный: разных
бескорыстный: бескорыстную
лечение: лечение
common: commons
продукт: продукты
некоммерческий: некоммерческая
минута: минуту
пособие: пособия
получать: получили
оказывать: оказываем
лицензия: лицензии
проект: проекты проект
беда: беда
спасибо: спасибо
сила: силах
taganrog: taganrog
возможность: возможностями
нуждающийся: нуждающимся
льгота: льготы
поддержка: поддержки поддержку
ипостась: ипостасях
интересно: интересно
гигиена: гигиены
нарушение: нарушением
активно: активно
платеж: платеж
задача: задачи
материал: материалы
вконтакте: вконтакте
регулярно: регулярно
питание: питания
creative: creative
ярослав: ярослав
ярослава: ярослава
помогать: поможет помочь
спастический: спастическая
статья: статьи
катастрофически: катастрофически
шаг: шаг
средство: средства
самый: самые самое самых
диплегия: диплегия
школа: школы
спонсор: спонсоров
слой: слоям
спинальный: спинальной
отправлять: отправьте
содержание: содержанию
обл: обл
мир: мире мир
официальный: официальная
помощь: помощи помощь помощью
пробел: пробел
одежда: одежды
деньги: денег
благотворительность: благотворительность
атрофия: атрофии
среда: среда
организация: организация
мочь: можете
добрый: добрый
поверить: поверить
желать: желаете
донбасс: донбасса
история: истории
сумма: сумму сумма
дцп: дцп
толстой: толстой
нужно: нужно
номер: номер
ответный: ответном
изменяться: изменились
категория: категорий
фестиваль: фестиваль
перенести: перенесен
переходить: перейти
ул: ул
предмет: предметов
ru: ru
работа: работу
сс: сс
сделать: сделать
сердечный: сердечное
инклюзивность: инклюзивность
мама: мама
сайт: сайта
строительство: строительство
семья: семье
спорт: спорта
попадать: попадая
ваш: вашей
приобретать: приобрести
fond: fond
хватать: хватает
zabota: zabota
незащищенный: незащищенным
мужественно: мужественно
город: городе
быть: будут
футбол: футбола
нужный: нужна
один: одна
выбирать: выбрать
будущий: будущие
обращаться: обратиться
сразу: сразу
мышечный: мышечной
партнер: партнеры
хотеть: хотите хочу
развитие: развитие
готовый: готова
мальчишка: мальчишки
внимание: внимание
нажимать: нажмите
равно: равно
привлечение: привлечения
непоседливый: непоседливые
среди: среди
годовой: годовые
