развивать: развивающие
фитнес: фитнес
английский: английский
личный: личном личный
смс: смс
развлекательный: развлекательные развлекательных
класс: классы класс
абонемент: абонементу абонемент абонемента абонементе
e: e
наслаждаться: наслаждайтесь
локация: локации
подтверждать: подтверждают
инструкция: инструкции
творческий: творческие
публичный: публичная
онлайн: онлайн
площадка: площадка
принимать: принимаете
посещать: посетить посещая
кабинет: кабинет кабинете
kid: kid
зарегистрироваться: зарегистрироваться зарегистрируйтесь
активация: активацию
добавлять: добавить
приобретать: приобретаете приобрести приобретая
информация: информация
это: это
адрес: адрес
бронирование: бронирования
быстро: быстро
следующий: следующему следующего
сайт: сайте
мы: нами
таеквандо: тхэквондо
доступный: доступные
стоять: стоят стоит
хореография: хореография
покупка: покупки
начинать: начала
неделя: неделю
определенный: определенное
балл: баллов баллах балл балла баллы
активность: активности
центр: центров
приобретение: приобретения
количество: количество
клик: клик
например: например
отправлять: отправить отправлены
промокод: промокод
оставаться: осталось
студия: студии студий студию
записываться: записываться записаться
показывать: показать
руб: руб
новый: новых
наш: наши нашем
секция: секций секции
занятие: занятие занятий занятия занятиями
кекс: кексам
французский: французский
т: т
работать: работает
развлечение: развлечений развлечения
регистрироваться: регистрируясь
окно: окно
петербург: петербург
прийти: придете придет
язык: языки язык
поздно: позднее
срок: срок
сертификат: сертификаты сертификат
указанный: указанную
задавать: задаваемые
единый: единый
такой: такое
раскрывать: раскрывайте
разнообразный: разнообразные
сервис: сервисом
либо: либо
кружок: кружки кружков
данный: данных
спорт: спорт
поздний: поздний
контактный: контактная
код: код кодом
детский: детский
подарить: подарить
использовать: использовали
электронный: электронной электронную
своевременно: своевременно
день: дня
кто: кого
хороший: лучшие
политика: политику политика
внутренний: внутренняя
пользователь: пользователям
аэротруб: аэротруба
создание: создания
единоборство: единоборства
рисование: рисование
вперед: вперед
администратор: администратору
согласие: согласие
ребенок: детей ребенка ребенку
купить: купить
талант: таланты
соляной: соляную
айкидо: айкидо
пароль: пароля пароль
сдача: сдачу
батут: батуты
познакомиться: познакомиться
капоэйр: капоэйра
утро: утро
семья: семьи
месяц: месяца месяц
санкт: санкт
подарочный: подарочный подарочные
запоминать: запомнить
почта: почты
покупать: покупаете
действие: действие
персональный: персональных
ура: ура
вход: вход
пример: примеру
один: одного
мастер: мастер
год: лет
регистрация: регистрации регистрация
вконтакте: вконтакте
возраст: возрасту
прид: прид
часто: часто
давать: даю
забывать: забыли
хотеть: хочет
тратить: тратите
помогать: помочь
отмена: отменах
стоимость: стоимость
менеджер: менеджеры
корпоративный: корпоративный
валюта: валюта
увидеть: увидеть
запись: записи
образование: образование
робототехника: робототехника
вводить: введите
ежедневно: ежедневно
иностранный: иностранные
бассейн: бассейны
отдел: отдел
почитать: почту
доступ: доступа
обработка: обработку
предложение: предложение
панда: панда
конфиденциальность: конфиденциальности
предупреждать: предупредят
приложение: приложении
входить: войдите войти
продлять: продлить
находить: найти
начинаться: начинается
нужно: нужно
сотрудничество: сотрудничество
откладывать: отложить
пользовательский: пользовательское
указывать: укажите
выбирать: выбрать выбираете выбранную
рассчитать: рассчитан
бронировать: бронировать бронируете
любой: любое
место: места
час: часа
сегодня: сегодня
москва: москва москвы
картинг: картинг
сколько: сколько
активировать: активировать
меню: меню
спортивный: спортивные
партна: партн
расписание: расписания расписание
творчество: творчество
послезавтра: послезавтра
соглашение: соглашение
закрывать: закрыть
смена: смены
проект: проекте
весь: всей
клиент: клиентов
дополнительный: дополнительное
каждый: каждое
комьюнити: комьюнити
kidmost: kidmost
который: который
телефон: телефон
катание: катание
назад: назад
пакет: пакет
забронировать: забронировать
парк: парк парки
пещера: пещеру
плавание: плавание
родитель: родителей
помощь: помощью
завтра: завтра
фигурный: фигурное
ры: ры
выгода: выгодой
сразу: сразу
скачать: скачайте
оферта: оферта
вопрос: вопросы
восстановление: восстановление
новичок: новичков
учетный: учетной
тема: теме
сделать: сделан
блог: блог
бесплатно: бесплатно
перенос: переносах
связываться: связаться
