нажимать: нажимая
салехард: салехард
ревда: ревда
энгельс: энгельс
оскол: оскол
истра: истра
онлайн: онлайн
музей: музеи
евгений: евгений
фильм: фильмы фильмов фильм
чт: чт
димитровград: димитровград
компания: компании компания
добавлять: добавить
серпухов: серпухов
лицо: лиц
елец: елец
поле: поле
ребенок: детей дети
ульяновск: ульяновск
рассылка: рассылка рассылок
полный: полной полное
абсурдистский: абсурдистская
марс: марс
дон: дону
новомосковск: новомосковск
самара: самара
декабрь: декабря декабрь
карта: карта
новороссийск: новороссийск
вагю: вагю
илимск: илимск
проводить: провести
петрозаводск: петрозаводск
северный: северной
правило: правилами
панкейков: панкейков
папа: папы
создавать: создать создайте
афиша: афиши афиша афише
долгопрудный: долгопрудный
орел: орел
дворец: дворец
doc: doc
апрель: апрель апреля
балаково: балаково
миграция: миграция
бранча: бранчи
нальчик: нальчик
псков: псков
сентябрь: сентября сентябрь
изменить: изменившие
зал: зал залы
балашов: балашов
отличный: отличных
королевство: королевство
комедия: комедия комедии
пушкинский: пушкинскому пушкинская
исторический: исторический
горный: горно
клуб: клубы клуб
ресторан: рестораны ресторан ресторанов ресторанах
imax: imax
мурманск: мурманск
арена: арена
сухоруков: сухоруков
трогательный: трогательной
невольница: невольницы
реклама: реклама
июль: июля июль
каникулы: каникулах
челябинск: челябинск
саранск: саранск
ожидать: ожидаемые
улан: улан
еда: еда едой
руза: руза
волгодонск: волгодонск
ужас: ужасы
август: август августа
октябрь: октябрь октября
можайск: можайск
бешенство: бешенство
май: мая май
выбор: выбор
главный: главные главный
пбк: пбк
колпино: колпино
сызрань: сызрань
брянск: брянск
сокол: сокол
консерватория: консерватории
каменск: каменск
обратный: обратная
курган: курган
гатчина: гатчина
март: март марта
дубно: дубна
защищать: защищены
ореховый: орехово
каталог: каталог
беляш: беляш
бойскаут: бойскаутов
мобильный: мобильное мобильная
находка: находка
самый: самые самый
кисловодск: кисловодск
ковер: ковров
реутов: реутов
ростов: ростов
daily: daily
живой: живыми
тамбов: тамбов
приложение: приложение
фрязино: фрязино
старший: старший
ноябрь: ноябрь ноября
белореченск: белореченск
лодейный: лодейное
дерзкий: дерзкий
мансийск: мансийск
сегодня: сегодня
кино: кино
вкусный: вкусные
посад: посад
ромкий: ромком
черемуха: черемухе
спортивный: спортивные спортивных
тихвин: тихвин
тюмень: тюмень
шеф: шеф
луна: луны
соглашение: соглашение
братск: братск
пятигорск: пятигорск
vr: vr
каждый: каждый
павловский: павловский
курганинск: курганинск
красногорск: красногорск
симферополь: симферополь
роман: роману
сумза: сумз
спорт: спорта спорт
чарующий: чарующая
новокузнецк: новокузнецк
мероприятие: мероприятие мероприятия мероприятий
невинномысск: невинномысск
городок: городок
родитель: родителей
всеволожск: всеволожск
выборг: выборг
право: права
лагерь: лагеря
кронштадт: кронштадт
ру: ру
дог: дог
okko: okko
бийск: бийск
который: которые
песня: песня
первый: первое
тота: тоту
ижевск: ижевск
махачкала: махачкала
калининград: калининград
туапсе: туапсе
связь: связь
альметьевск: альметьевск
абакан: абакан
клинцы: клинцы
белгород: белгород
домодедово: домодедово
спасск: спасск
старый: старше старый
онегин: онегин
площадка: площадки
лысьва: лысьва
тагил: тагил
новый: новых новые новый
ср: ср
армавир: армавир
солнечногорск: солнечногорск
мценск: мценск
стекло: стеклом
стадион: стадион
мюзикл: мюзикл
редакция: редакция
июнь: июня июнь
рубцовск: рубцовск
амур: амуре
пышка: пышка
кострома: кострома
человек: человек
предложение: предложения
петербург: петербурга петербурге петербург
сб: сб
волжский: волжский
удэ: удэ
наводить: наведите
уэса: уэса
другой: другие
отпраздновать: отпраздновать
праведник: праведник
таганок: таганке
г: г
блинчик: блинчики
концерт: концертов концерты
битва: битва
анна: анна
мультфильм: мультфильм
джаз: джаз
сосновый: сосновый
купить: купить
химки: химки
почта: почте
коломна: коломна
кузнецк: кузнецк
устричный: устричный
игра: игра
театр: театр театры театров
ноябрьск: ноябрьск
баскетбол: баскетбол
черкесск: черкесск
санкт: санкт
одри: одри
майкоп: майкоп
пермь: пермь
оренбург: оренбург
кириши: кириши
удобный: удобный
детский: детские детских
сестрорецк: сестрорецк
петропавловск: петропавловск
оперетта: оперетты
втб: втб
курск: курск
вампилов: вампилова
магнитогорск: магнитогорск
триллер: триллер
полиция: полиция
столица: столицы
месяц: месяц
новочебоксарск: новочебоксарск
алтайск: алтайск
вт: вт
развлечение: развлечения
кингисепп: кингисепп
вс: вс
план: планы
тула: тула
темп: темп
м: м
поваров: поваров
концертный: концертные
нягань: нягань
бердск: бердск
подольск: подольска подольск
кнопка: кнопку
ломоносов: ломоносов
звенигород: звенигород
каспийск: каспийск
новосибирск: новосибирск
барнаул: барнаул
драматический: драматический
йошкар: йошкар
новокуйбышевск: новокуйбышевск
подборка: подборки
архангельск: архангельск
стартовать: стартовал
возможность: возможность
норильск: норильск
башня: башня
страница: страницу
расписание: расписание
скоро: скоро
азы: азов
русский: русская
новоалтайск: новоалтайск
сайт: сайта
уфа: уфа
ооо: ооо
непослушный: непослушная
белорецк: белорецк
саров: саров
заведение: заведение
балашиха: балашиха
премьера: премьеры
январь: января январь январе
бузулук: бузулук
свой: своего
рок: рок
верхний: верхняя
саратов: саратов
кемерово: кемерово
мир: мир мире
липецк: липецк
красноярск: красноярск
тольятти: тольятти
новошахтинск: новошахтинск
бор: бор
мама: мам
толстой: толстого
стендап: стендап
лыткарино: лыткарино
побег: побег
сходить: сходить
игорь: игоря
сын: сын
посещать: посетить
луховицы: луховицы
бар: бар
смоленск: смоленск
это: это
хоккей: хоккей
хабаровск: хабаровск
неделя: неделю неделя недели
екатеринбург: екатеринбург
день: день
фоминск: фоминск
павлово: павлово
камышин: камышин
лесна: лесной
ангарск: ангарск
нефтекамск: нефтекамск
новоуральск: новоуральск
успевать: успеть
рассказывать: рассказать
пробуждение: пробуждение
миасс: миасс
спартак: спартак
гудермес: гудермес
усть: усть
феодосий: феодосия
шахта: шахты
коряжма: коряжма
пт: пт
комсомольск: комсомольск
бугуруслан: бугуруслан
иркутск: иркутск
ачинск: ачинск
якутск: якутск
hot: hot
событие: событий события
чебоксары: чебоксары
сатира: сатиры
пенза: пенза
североморск: североморск
стерлитамак: стерлитамак
новость: новости
политика: политика
артем: артем
одинцово: одинцово
нижневартовск: нижневартовск
андерсон: андерсона
новгород: новгород
вологда: вологда
чехов: чехов
билет: билетов билеты
стейк: стейки
угмк: угмк
время: время
выходной: выходные
программный: программному
мвтб: мвтб
уральский: уральский
озеры: озеры
orchestra: orchestra
против: против
бк: бк
гения: гения
бит: бит
выставка: выставок выставки
посещаемость: посещаемость
батайск: батайск
масленица: масленицу масленица
киров: киров
клин: клин
губкин: губкин
наро: наро
сургут: сургут
пушкино: пушкино
соглашаться: соглашаетесь
пикник: пикник
владимир: владимир
орск: орск
c: c
томск: томск
петергоф: петергоф
мимоза: мимоза
пн: пн
сергиев: сергиев
трагикомедия: трагикомедия
астрахань: астрахань
лев: льва
железногорск: железногорск
нефтеюганск: нефтеюганск
пушкин: пушкин
пончик: пончики
путеводитель: путеводители
фестиваль: фестиваль
яшин: яшина
ессентуки: ессентуки
элиста: элиста
марлоу: марлоу
сеть: сетях
ступино: ступино
воскресенск: воскресенск
жуковский: жуковский
виктор: виктор
краснодар: краснодар
иваново: иваново
электросталь: электросталь
калуга: калуга
свободный: свободное
рыбинск: рыбинск
таганрог: таганрог
дальний: дальний
rman: rman
дзержинск: дзержинск
выбирать: выбрать
завтра: завтра
копейск: копейск
северск: северск
уссурийск: уссурийск
вопрос: вопросы
кинотеатр: кинотеатры кинотеатров
заречный: заречный
нижнекамск: нижнекамск
краснознаменск: краснознаменск
советский: советские
сертификат: сертификаты
сцена: сцена
назрань: назрань
дмитров: дмитров
идеальный: идеальном
октябрьский: октябрьский
салават: салават
отличник: отличники
пышма: пышма
uma: uma
шедевр: шедевра
gallery: gallery
первоуральск: первоуральск
прокопьевск: прокопьевск
озерск: озерск
фильмотека: фильмотека
ханты: ханты
ялта: ялта
челн: челны
спектакль: спектакли спектаклей
геленджик: геленджик
московский: московский московская
эстрадный: эстрадный
интерактивный: интерактивная
витязь: витязь
должный: должна
зверев: зверев
северодвинск: северодвинск
раменское: раменское
контакт: контакты
камчатский: камчатский
муром: муром
набережная: набережные
лобня: лобня
уренгой: уренгой
заклятие: заклятье
задавать: задаваемые
нижний: нижний
зеленогорск: зеленогорск
владикавказ: владикавказ
искитим: искитим
бутман: бутмана
основной: основная
возврат: возврат
москва: москва москвы москве
пиво: пиве
каренин: каренина
видный: видное
арзамас: арзамас
сыктывкар: сыктывкар
омск: омск
волгоград: волгоград
танец: танцами
королев: королев
увеличивать: увеличить
версия: версия
южный: южно
ола: ола
гусь: гусями
вахтангов: вахтангова
многомиллионный: многомиллионной
кстово: кстово
магадан: магадан
зарайск: зарайск
февраль: февраль февраля
рязань: рязань
ярославль: ярославль
казань: казань
зуево: зуево
березник: березники
смалец: смалец
вольск: вольск
грозный: грозный
бугульма: бугульма
камера: камеру
год: лет
владивосток: владивосток
уникальный: уникальную
люберцы: люберцы
аудитория: аудитории
руно: руна
часто: часто
ещ: ещ
скрк: скрк
специальный: специальные
полцены: полцены
динамо: динамо
великий: великий
евпатория: евпатория
златоуст: златоуст
кубинка: кубинка
соц: соц
способ: способ
череповец: череповец
подписываться: подписаться
мытищи: мытищи
демпинг: демпинг
конфиденциальность: конфиденциальности
тверь: тверь
сочи: сочи
зенит: зенит
нужно: нужно
амели: амели
пользовательский: пользовательское
пять: пять
обнинск: обнинск
дорогой: дорогой
благовещенск: благовещенск
севастополь: севастополь
воронеж: воронеж
сахалинск: сахалинск
большой: большой
щелково: щелково
цска: цска
ивантеевка: ивантеевка
проект: проекты
havana: havana
ногинск: ногинск
календарь: календарь
центр: центр
ставрополь: ставрополь
центральный: центральный
дк: дк
дербент: дербент
зеленоград: зеленоград
новогодний: новогодних
немой: нем
чита: чита
