мясной: мясные
пермь: пермь
варение: варенье
конфи: конфи
ул: ул
мир: мира
кекс: кекс кексы
обед: обед
глютен: глютена
ужин: ужин
торт: торты
кулинарный: кулинарная
студия: студия
товар: товаров
покупка: покупок
шеф: шеф
поступление: поступления
печение: печенье
оплата: оплата
вареник: вареники
пельмень: пельмени
завтрак: завтрак
адрес: адрес
г: г
соление: соленья
апельсин: апельсин
продажа: продаж
корзина: корзина
октябрь: октября
доставка: доставка
тарт: тарты
р: р
телефон: телефон
фундук: фундук
сыр: сыром
купить: куплено
новый: новые
цыпленок: цыпленка
лидер: лидеры
вкус: вкуса
мраморный: мраморной
телятина: телятиной
контакт: контакты
