реабилитация: реабилитации
россия: россии
ваш: вашего вашей вашим
пожертвование: пожертвование пожертвования
rub: rub
болеть: болеет
особый: особая
поддерживаться: поддерживается
использование: использования
office: office
серьезный: серьезного
name: name
подарить: подари
диагностика: диагностики
являться: является
акция: акции
sberbank: sberbank
поступление: поступлениях
прочитывать: прочесть
информация: информация
gmail: gmail
лицо: лиц
получать: полученных
получатель: получателя
вы: вами
цель: целью цели
размер: размер
отчет: отчет
связь: связи
benifciary: benifciary
больной: больным
препарат: препаратами
слово: слово
тело: тел теле
благодарность: благодарность
ребенок: ребенка детям детьми детей ребенку ребенок
сайт: сайт сайтов сайта
проект: проекта проект
взнос: взносов
например: например
www: www
год: года
заболевание: заболеваниями заболевания
рамка: рамках
вносить: внести
благотворительный: благотворительные благотворительный
добровольный: добровольных
бик: бик
контакт: контакты
июль: июля
фонд: фонде фонд фонда
учреждение: учреждениям
врач: врачи
выздоравливать: выздоровел
отзыв: отзывы
болезнь: болезнью
малышка: малышка
программа: программы
система: системах системы
юридический: юридических
л: л
снабжение: снабжению
осуществляться: осуществляется
создание: создание
sm: sms
поодиночке: поодиночке
данный: данных
swift: swift
поддержка: поддержки поддержка
usd: usd
уход: уходу
г: г
мы: нам
сообщение: сообщение
тег: тег
абонент: абонента абонентов
новость: новости
допустимый: допустимый
противогрибков: противогрибковами
рубль: рублей
формирование: формирование
рекомендовать: рекомендую
reference: reference
документ: документы
child: children
очень: очень
средство: средств
согласие: согласие
н: н
потратить: потрачено
лечение: лечения лечение
com: com
помогать: помогаем помочь
кто: кому
отправлять: отправьте отправив
donation: donation
оплата: оплату
счет: счет счета
dorus: dorus
выбор: выбора
санкт: санкт
eur: eur
билайн: билайн
платежный: платежной платежных
персональный: персональных
сотовый: сотовой
инн: инн
оказание: оказание
комиссия: комиссия
code: code
пропасть: пропасть
важный: важными
выставка: выставки
короткий: короткий
отправка: отправки
признавать: признали
давать: даю
стоимость: стоимость
zapadny: zapadny
жизнь: жизнь
онкозаболевание: онкозаболеваниями
поступать: поступила
публичный: публичной
прямо: прямо
кор: кор
рука: руки
свое: свое
цифра: цифрами
нко: нко
мтс: мтс
каталог: каталог
противоопухолевый: противоопухолевыми
р: р
паллиативный: паллиативная
начинать: начал
деятельность: деятельность
помощь: помощи помощь помощью
реализовать: реализует реализующим
пробел: пробел
обработка: обработку
интернет: интернет
мочь: можете
договор: договор
bank: bank
оператор: оператора
acc: acc
доступный: доступна
гражданин: граждан
бессилие: бессилие
также: также
сумма: сумму сумма
друг: друзья
оферта: оферты
robokassa: robokassa
боль: боль
номер: номер
audio: audio
severo: severo
нуждающийся: нуждающихся
politics: politics
имущество: имущества
медицинский: медицинским
сидоров: сидорова
указывать: укажите
email: email
sabrru: sabrru
сбербанк: сбербанка
ru: ru
нуждаться: нуждается
данные: данными
head: head
federation: federation
adress: adress
иммунотерапевтический: иммунотерапевтическими
трудный: трудного
банка: банка
payment: payment
мегафон: мегафон
sersid: sersid
право: право
семья: семье семьям
псков: пскова
браузер: браузером
деньги: деньги
поздно: поздно
закупка: закупке
хватать: хватает
наименование: наименование
другой: другими
жизненно: жизненно
перечислять: перечислить
услуга: услуга
необходимый: необходимой
кпп: кпп
хотеть: хочу хотим
beneficiary: beneficiary
основа: основе
нужный: нужна
защита: защиты
тяжело: тяжело
завтра: завтра
взяться: возьмемся
отделение: отделение
бесплатно: бесплатно
p: p
russian: russian
bic: bic
петербург: петербурга
