сутки: сутки
пешеход: пешехода
рф: рф
поездка: поездке
притормаживать: притормозил
продолжать: продолжая
сгорание: сгорания
соболь: соболь
снова: снова
пятилетний: пятилетний
он: нему
автомобиль: автомобилей автомобили автомобиля автомобиле автомобиль
честный: честный
журналист: журналистов
который: которых которые которая
сhevrolet: сhevrolet
китаец: китайцы китайца
ввозить: ввозить ввезенный
въезжать: въезжать
поделиться: поделитесь поделился
водитель: водители водитель водителей водителям водителю
распитие: распитие
надежно: надежнее
форум: форум
hyundai: hyundai
японски: японски
готовить: готовит
км: км
кроссовер: кроссоверы кроссоверов кроссовера кроссовер
круг: круг
импорт: импорт импорту
земля: земле
старожил: старожил
видео: видео
греть: греть
подкачка: подкачке
молодой: молодые
наш: наш наши нашей нашим
mitsubishi: mitsubishi
лазейка: лазейка
дизель: дизель
интерес: интерес
давать: дают даете
новый: новый новому новейшую новая новых новые
продаваться: продается
неплохой: неплохой
автопром: автопрома
какой: каким каком какие
параллельный: параллельному параллельный
изменение: изменений
ремонт: ремонт
поколение: поколении
конь: конь коня
одноклассник: одноклассников
кто: кого
хороший: лучшие лучшее лучший
стоять: стоит
онф: онф
нюанс: нюанс
технический: техническим
современный: современный
bora: bora
очень: очень
реклама: рекламы реклама
брать: берем
детская: детская
ситуация: ситуация
лоск: лоск
рассылка: рассылки
становиться: стало стал станет
цель: целях
запчасть: запчасти запчастями запчастей
cx: cx
такой: такого такие
иномарка: иномарок
называть: названы назвали назван
ускорять: ускорившим
отменять: отменили
рука: руками руки
задача: задачи задача
выбор: выбор
главный: главным главные
mercedes: mercedes
находиться: находящейся
развитие: развития
награда: награда
зима: зимой
впрыск: впрыском
алкоголь: алкоголя
март: марта
выпускаться: выпускается
выявлять: выявил
заполнять: заполнив
номер: номера номер
спор: споре
ford: ford
мотор: мотору
достойный: достойная
москвич: москвич москвича
россия: россии россию
интернет: интернете интернет
собираться: собирается
экспертиза: экспертиза
самый: самый самое самой самых самые
полезный: полезных
lada: lada
попутчик: попутчика
практичный: практичная
тянуть: тянет
линейка: линейка
нестандартный: нестандартная
сегодня: сегодня
должный: должен
выставлять: выставляем
выбирать: выбираем выбрали
спасать: спасти
наказывать: наказал
nn: nn
пора: порой
бренд: бренды бренд
вечный: вечный
националист: националистов
полк: полку
редакционный: редакционного
высокий: высокой высоким
иномарочный: иномарочный иномарочны
адекватный: адекватной
прямой: прямая прямым
китайский: китайского китайский китайских
важный: важных важнейшее важный
лайфхаки: лайфхаки
проваливать: проваливают
функционировать: функционирует
фотогид: фотогид
законный: законно
голос: голосов
сделать: сделано
право: права правах
тонировка: тонировку
новое: нового
хотеть: хотите
двигатель: двигатель двигателей двигателя
грезить: грезили
рецепт: рецепт
крылатый: крылатого
перестраиваться: перестроились
bmw: bmw
ошибаться: ошибаются
внедорожник: внедорожников внедорожник
налаживать: наладят
xpander: xpander
опытный: опытных
другой: другого
рейнджер: рейнджеры
вовсе: вовсе
проблема: проблема проблем
зона: зоне
cookie: cookie
пилотировать: пилотируемый
аналог: аналогов
попадать: попала
старый: старый
издательство: издательство
автомобильный: автомобильный автомобильным
тыс: тыс
мужчина: мужчины
связь: связи
возраст: возрасте
зимний: зимних зимней
альтернатива: альтернатива
эксплуатация: эксплуатации
просто: проще просто
проезд: проезда
практически: практически
издание: издании издание
дорога: дорогах дорогам
перевозить: перевозящим
редакция: редакция редакции
появляться: появились появилась
проверять: проверять проверяет проверено
надежный: надежно надежный
платный: платным
отзыв: отзывы
черников: черников
ехать: едет
грузовик: грузовики грузовик
популярный: популярное
устройство: устройство
упрощенный: упрощенный
министерство: министерства
сми: сми
седан: седаном
расти: расти
атмосферник: атмосферник
раздражать: раздражающих
одобрять: одобрены
выясняться: выяснилось
превращать: превратить
дешево: дешево дешевле
лад: ладу ладе
подорожать: подорожали
переплачивать: переплачивать
проводить: провел
тест: тест тесты
мощность: мощность
купить: купить
файл: файлов
рейд: рейды
вариатор: вариатором
chevrolet: chevrolet
путь: путями
профессионал: профессионалов
производство: производства
потребительский: потребительские
млн: млн
фактор: фактора
газ: газ
кольцо: кольца
задачка: задачка задачки
российский: российской российские
конференция: конференции
изменяться: изменится
volkswagen: volkswagen
точка: точка
приз: призом
стоимость: стоимость
автодом: автодома
месяц: месяц
михаил: михаил
sportage: sportage
продажа: продаже
незаметный: незаметный
бюджетный: бюджетным
нужный: нужен
качество: качеством
показатель: показателям
китай: китае
автомобилист: автомобилисты
nissan: nissan
цифровой: цифрового
госавтоинспекция: госавтоинспекции
вторичка: вторичке
приходить: приходят
вместо: вместо
бросать: бросить
дешевый: дешевой
отличаться: отличаются
порядок: порядок
система: системе
неприхотливый: неприхотливый
цена: цене ценой
история: история
сайт: сайта сайт
легко: легко
подтверждать: подтверждала
парк: парка
поистине: поистине
голова: голову
шикарно: шикарно
совет: советы
ссср: ссср
назад: назад
наказуемый: наказуемо
зр: зр
почетный: почетное
быть: будем будут
европеец: европейца
смерть: смерть
процесс: процесс
б: б
тойота: тойота
миф: мифов
неожиданно: неожиданно
прицеп: прицепы
пропуск: пропуск
элита: элита
финансовый: финансовой
колодка: колодок
жизнь: жизни
тесто: тестах
тесло: тесла
глава: глава
груз: груз грузы
мм: мм
проходить: прошел прошла
это: это
mazda: mazda
лайфхак: лайфхаком
летать: летающий
получать: получите получит получившие
отвечать: ответили
поршневой: поршневых
массовый: массовое массовых
приверженец: приверженец
звание: звание
цилиндр: цилиндрах
продлиться: продлятся
гарантия: гарантию
редкий: редчайших
обстрел: обстрелом
поныне: поныне
год: году года лет
линия: линия
замена: замену заменой
красивый: красивая
легендарный: легендарный
отечественный: отечественного
переключаться: переключились
анкета: анкету
всмятку: всмятку
интересный: интересные
соцсеть: соцсетях
запутываться: запутаться
шина: шин
мкп: мкп
рассказывать: рассказываем
читатель: читатель читателя
возникать: возник
оставаться: остаюсь
r: r
пдд: пдд
актуальный: актуальное
федерация: федерации
хитрость: хитрость
танк: танки
россиянин: россияне
поставлять: поставлена
мы: нам
серый: серыми
испытание: испытания
новость: новости
клиренс: клиренс
ценный: ценный ценные
драйв: драйвы
военный: военным
время: время
пресс: пресс
выходной: выходные
светодиод: светодиоды
дело: дело
дача: дачи
здорово: здорово
удивительный: удивительная
понадобиться: понадобится
правило: правила
toyota: toyota
мероприятие: мероприятия
низкий: низкой
реально: реально
авторынок: авторынке
техника: техника
использоваться: используется
этот: эта
официально: официально
питание: питания
часто: чаще часто
спрашивать: спрашивали
куча: куча
шанс: шанс
особый: особый
мысль: мысли
объяснять: объясняем
иностранный: иностранных
обработка: обработку
самоходка: самоходку
журнал: журнал журнала
добрый: добрый
архив: архив
герой: герой
аккумулятор: аккумулятор
выигрывать: выиграй выиграть
автомат: автомат
драгоценный: драгоценная
широко: шире
cross: cross
машина: машины
санкция: санкции
правовой: правовая
гибдд: гибдд
сколько: сколько
сохранять: сохранить
использовать: использовать использовало
знание: знание
загружать: загрузить
легковой: легковые
новинка: новинка
замечать: заметили
претензия: претензию
город: города
рейс: рейс
магазин: магазин
усиленный: усиленные
вездеход: вездеход
вопрос: вопросы
восстановление: восстановление
повадка: повадки
свежий: свежий
возможность: возможности
убивать: убить
возрождать: возродит
обретать: обрел
инспектор: инспектор
согласный: согласны
припарковывать: припаркованном
британский: британские
ларгус: ларгус
существо: существу
первый: первый первые
подогрев: подогрев
выглядеть: выглядит
внутренний: внутреннего
информация: информация
разбирать: разбирает
автозапчасть: автозапчасти
пока: пока
поездить: поездили
автотовары: автотовары
несмотря: несмотря
renault: renault
человечество: человечество
cobalt: cobalt
выгодный: выгодный
карбюратор: карбюратор
уничтожать: уничтожит
leopard: leopard
контакт: контакты
подбирать: подберу подбираем подобрать
выпуск: выпуска
эксперт: экспертами
водительский: водительская
коммуникация: коммуникаций
w: w
фишка: фишек
компания: компания
бежать: бежать
рубль: рублей
е: е
обычный: обычных
отрывать: отрывают
согласие: согласие
версия: версия
все: всем
авто: авто
везти: повезли
февраль: февраля
привозить: привезли
недавно: недавно
они: ними
автор: авторы
известно: известно
безальтернативный: безальтернативно
kia: kia
руль: рулем
поддержка: поддержке
ha: ha
гран: гран
хотя: хотя
пробег: пробегом
статья: статьи
ещ: ещ
эксплуатационный: эксплуатационным
фильтр: фильтры
рама: рама
мнение: мнение
вид: виде
уаз: уаз
продлять: продлят
поиск: поиск
гаджет: гаджетов
сидение: сидений
украинский: украинских
зарядник: зарядник
смертность: смертностью
skoda: skoda
опрос: опросы
подписываться: подписаться
подписка: подписка
японка: японок
медсправка: медсправку
вест: весты
модель: модель моделей
день: дни
benz: benz
обходиться: обойтись
пробовать: пробовали
штраф: штрафы
сво: сво
материнский: материнская
ранее: ранее
неисправность: неисправностей
свой: своим
недорогой: недорогая
подарок: подарок
масло: масло
поступать: поступают
полюбить: полюбили
решать: решена
комплектующий: комплектующие комплектующи
бить: бьют
японец: японца
представлять: представляла
результат: результатом
вариант: варианты
три: трех
прекрасы: прекрас
марка: марки
наверх: наверх
функционирование: функционирования
немой: нем
ждать: жду
среди: среди
