сутки: сутки
два: двух две
чужой: чужим
свежий: свежие
кодинг: кодинг
обожать: обожаю
индексация: индексация
наверное: наверное
пост: постов посте пост
появляться: появилась появляются появился
тот: та тех те той ту
diagram: diagram
пользователь: пользователи пользователя пользователей пользователю
снова: снова
подробно: подробнее
будущее: будущее
плагин: плагин плагинов
оставлять: оставившему
андрей: андрей
предыдущий: предыдущих
термин: термин
асимметричный: асимметричное
именно: именно
рубрика: рубрики рубрике
сто: ста
сон: сном
ева: ева
запрещать: запрещено
слой: слой
сам: сами саму
кеширование: кеширование
главный: главная главнее
приватный: приватный приватным
написать: написано написали написал
количество: количество количеством
требовать: требует
исполнять: исполнить
чик: чик
работать: работает работают работаю работать
наглядно: наглядно
мой: моих мои моей
тьи: тьи
неудобство: неудобства
отправлять: отправить
битный: битные битной битную
ответ: ответ ответа ответы
статья: статьи статей статья статье статью
автодеплый: автодеплой
боб: боб
наш: наши
попутно: попутно
железо: железо
публичный: публичный
т: т
org: org
существовать: существовало
кук: кук
срок: срок
ошибка: ошибки ошибок
некоторые: некоторых
сложный: сложной
продвигать: продвинутые
ведение: ведения
навигация: навигация
тип: типы
представлять: представляете представим
жуть: жути
javascript: javascript
ssl: ssl
ех: ех
image: images
менее: менее
система: систем системы
владыкин: владыкин
представляться: представляется
кто: кого кому
ломать: ломает
официальный: официальный
решать: решил решить
грустно: грустно
очень: очень
позволять: позволяет
реклама: реклама
брать: берем
настраивать: настроят настраивать
русский: русский
cхема: cхема
настройка: настройки
материал: материала
изображение: изображений изображения
прошлый: прошлая
такой: такое такие
беда: беда
удаваться: удалось
выдавать: выдает
android: android
огромный: огромные огромное
веха: вехой
sleep: sleep
язык: язык языков
пример: примеру
сожаление: сожалению
чуточку: чуточку
обходить: обходимо обойти
благодаря: благодаря
хранить: хранить
продолжать: продолжим
точный: точные
очередь: очередь
остав: остав
взять: взять
ресайз: ресайз
стоить: стоил
injection: injection
специальный: специальный
максимально: максимально
средство: средствами средства
изначально: изначально
допустимый: допустимое
ственный: ствен
хоститься: хостился
каталог: каталог каталоге
объяснять: объясняет объяснить
показатель: показатель
сям: сям
страница: страница страницу страницы страниц
данный: данных данном данный
интернет: интернет
sql: sql
http: https http
убого: убого
передавать: передаем
факт: факты
платформа: платформы платформе
wordpress: wordpress
подлый: подлая
поставлять: поставил
дело: дела
скоро: скорее
мозаика: мозаики
относительно: относительно
mvc: mvc
простой: прост простым
читать: читали читать
случай: случае случай случаи
продакшень: продакшене
обфускация: обфускация
сегодня: сегодня
функционал: функционалу
прибегать: прибегнув
смочь: смогла сможет
давать: давало давайте давали
working: working
sweb: sweb
уходить: ушел
грех: грех
данные: данные данными
капча: капчу капча
нужный: нужен нужны
gitolite: gitolite
заглушка: заглушку
каждый: каждого каждой каждый
ки: ки
антиреклама: антиреклама
проект: проекта проекты проект проекте проектов
linux: linux
канал: каналу
деплоить: деплоя
ресурс: ресурс ресурсы
память: памяти память
понимать: понимаете пойму понял
ssh: ssh
автоматически: автоматически
помощь: помощью
цифровой: цифровая
второй: втором вторых второй
написание: написание
таки: таки
пыль: пыли
безопасность: безопасность
репозиторий: репозиториями репозиторий репозитории репозиториям репозиториев
отключать: отключить
рбк: рбк
шифровать: шифруем
mysql: mysql
наглядность: наглядность
который: которыми который которые которому которое которым
незадача: незадача
хотеть: хочу хотим
совершать: совершать
небезопасный: небезопасное
амиров: амиров
непосредственно: непосредственно
источник: источник
кешировать: кешированными кешировать
инъекция: инъекцию инъекция
традиция: традиция
let: let
любить: люблю
соб: соб
ра: ра
взлом: взлом взлома
ре: ре
де: де
мыслить: мысля
пересохранять: пересохранять
то: тому
ключ: ключ ключа ключи ключам ключом
следствие: следствие
гарантировать: гарантировать
размер: размера размер размеры
ускорять: ускоряем
следующий: следующей
ные: ные
писать: пишем пишешь
вернуть: вернул
сервер: сервера серверу сервер серверов сервере
юмор: юмор
простенький: простенький
сервис: сервису сервиса сервис
ребенок: ребенок
приходиться: пришлось
просто: просто
алгоритм: алгоритма алгоритмы алгоритм
добавлять: добавляем добавил
пропадать: пропадают
занимать: заняли
www: www
алиса: алисы алиса
intsystem: intsystem
комментарий: комментарии комментария комментариев комментарий
любой: любую любые любого
знать: знать знает
скриптовый: скриптовые
щаю: щаю
запрос: запроса запросе
извлекать: извлечь
установка: установки
понятный: понятная
первый: первом первых
версия: версии
обработка: обработка
auth: auth
сертификация: сертификации
клиент: клиента
production: production
должный: должны должной
site: site
большой: большое велика
расшифровывать: расшифровывает
метка: метки
вечер: вечер
сертификат: сертификатов сертификатом сертификаты сертификат
другой: другие другая
больший: большего большая
comodo: comodo
генерация: генерацию
html: html
свой: своем своим свои своих свой
либо: либо
просрочивать: просроченных
товар: товара товаров товары
ресайзить: ресайзить
дима: дима
трафик: трафик
проблема: проблемам
оказываться: оказывается
бинарный: бинарный бинарному
замер: замере
весь: вся
перевод: перевод
устанавливать: установят
секунда: секунд
csrf: csrf
знакомый: знакомый
уязвимость: уязвимость
разработка: разработка разработки
шифрование: шифрование шифрования
адрес: адресов адрес
сокращать: сократить
подключение: подключениям
большинство: большинство
различный: различных
сохранять: сохранить сохраняя сохраненная сохранять
впечатление: впечатления
sencrypt: sencrypt
технология: технологии
здравствовать: здравствуйте
типичный: типичном
адресат: адресат
nginx: nginx
ния: ния
почта: почты
криптография: криптографии криптография
четыре: четыре
прочитывать: прочитайте
апи: апи
считаться: считается
приходить: прийти
captcha: captcha
зайти: зайдешь
атака: атаки
действие: действия
гб: гб
раз: раза
картинка: картинкой картинка картинку картинках картинок картинки
похожий: похож
никакой: никаких
шу: шу
php: php
лять: лять
хранилище: хранилище
некий: некий
прекрасный: прекрасную
план: планы
начинать: начал
информация: информации
интересный: интересные интересная интересных
относиться: относится
собственно: собственно
складываться: сложилось
управлять: управляем управлять
амирова: амирова
развитие: развитии
карать: карать
сподвигнуть: сподвигло
пазл: пазлами
последующий: последующим
заниматься: заниматься
переходить: перейти
использование: использование
ге: ге
выполнение: выполнения
поиск: поиск поиску
возможность: возможности возможность
удаленный: удаленному удаленная удаленный удаленного
работа: работы работу работе
слово: слов словах словам
использовать: используя используют использовать использует
меню: меню
приблизительный: приблизительная
история: история
автор: автор автору
удобно: удобно
легко: легко
яндекс: яндекс
находить: найти найдена
медет: медет
class: class
кратце: кратце
база: базы базе
задаваться: задастся
парировать: парирует
передача: передачу
защита: защиты защиту защита
переконфигурация: переконфигурация
изменять: изменять
делать: делает
надеяться: надеюсь
я: мной
требование: требования
абсолютно: абсолютно
блог: блога блогу блог
сфе: сфе
задержка: задержки
электронный: электронной
компьютер: компьютеров
large: large
конец: конце
процесс: процесс
хотеться: хотелось
дешифрование: дешифрование
опыт: опыта
дмитрий: дмитрий
мена: мен
опубликовывать: опубликовано
сказываться: сказывается
отресайзить: отресайзить
чтож: чтож
продолжительный: продолжительное
общеизвестный: общеизвестная
agent: agent
среднее: среднем
раса: рас
число: числами число
ассиметричный: ассиметричного ассиметричное
конструкция: конструкции
ругаться: ругаться
схема: схема
погружаться: погружаться
это: это этому
итого: итого
архитектура: архитектуру
спарсить: спарсишь
long: long
вдохновлять: вдохновляет
попробовать: попробовать попробую
хостинг: хостинге
форма: формы
отчет: отчет
взломщик: взломщик
абзац: абзац
ся: ся
управление: управлением
обеспечивать: обеспечивая
выводить: выводить выводит
токен: токен
encrypt: encrypt
сайт: сайт сайтов
например: например
деплый: деплой
правило: правило
список: список
запись: записям
год: года
сеть: сети
главное: главное
последний: последнее последняя
insys: insys
техподдержка: техподдержку
приветствовать: приветствую
событие: событие
читатель: читателям
поддерживать: поддерживает поддерживают
падать: падает
тан: тан
возникать: возник
mikemackintosh: mikemackintosh
программирование: программирования программирование
интерактивный: интерактивную
благодарить: благодарю
bit: bit
ассимитричный: ассимитричное
содержимый: содержимому
осуществляться: осуществляется
операционный: операционных
оплата: оплата
jpeg: jpeg
удаляться: удаляются
недоверенный: недоверенным
конфига: конфиги
мы: нам
сообщение: сообщений сообщение
прямой: прямой
дух: духом
символ: символов
родительский: родительский
vps: vps
купить: купленный
based: based
частенько: частенько
ный: ный
нецелесообразный: нецелесообразным
суж: суж
массив: массивы
экономически: экономически
вай: вай
время: время времени
согласный: согласен
com: com
right: right
здорово: здорово
удобный: удобное
википедия: википедии
жалко: жалко
отвечать: отвечают
месяц: месяца
переводить: переводить
user: user
ден: ден
исполняться: исполняется
жутко: жутко
firefox: firefox
юзабилити: юзабилити
алексей: алексей
бит: бит
фильтрация: фильтрация
промахиваться: промахиваются
допускать: допускает
насколька: насколька
формула: формула
распознавание: распознавание
seo: seo
тема: тему
сильно: сильно
вектор: вектор
доставлять: доставить
двухгодовалый: двухгодовалый
ным: ным
момент: момент
пароль: пароль
мысль: мысли
ком: ком
сфера: сфере
следить: следить
основываться: основывается основывался
включать: включенных
любовь: любовью
вопрос: вопрос
вообще: вообще
максимальный: максимальным
значительно: значительно
ом: ом
пользовательский: пользовательского
несоизмеримо: несоизмеримо
вместе: вместе
получать: получат получил
обо: обо
google: google
постоянный: постоянные
коммерческий: коммерческих
помогать: поможет
интервью: интервью
задача: задачей задача
конфигурация: конфигурация
случайный: случайному
часть: часть
netcat: netcat
зашифровывать: зашифрованное
везти: повезло
называть: называет
имя: именем
происходить: происходит
далее: далее
вольный: вольный
тег: теги
взламывать: взломал
leginin: leginin
бесить: бесили
include: include
упасть: упал
tip: tips
шифрованный: шифрованным
тормознутость: тормознутости
забвение: забвения
кат: катом
вать: вать
проксирование: проксирование
создавать: создан
бывать: бывает
цель: целью
приводить: приводит
git: git
бот: бот
суть: сути
традиционный: традиционный
видно: видно
авторизовать: авторизуя
иной: иная
немножко: немножко
замечать: заметил
browser: browser
влиять: влияет влияя
сбор: сбора
сдуть: сдул
являться: является
выглядеть: выглядит
подписываться: подписываться
команда: команды
стопроцентный: стопроцентную
всякий: всякий
плюс: плюс
посредством: посредством
копирование: копирование
похвастаться: похвастаться
пи: пи
центр: центр центров
понимание: понимания
отжирание: отжирания
остальной: остальными
обычный: обычное
рес: рес
пользоваться: пользоваться
reserved: reserved
самый: самое самой самым
обыч: обыч
проходить: прошло
подытоживать: подытожим
локально: локально
прочее: прочее
x: x
один: одну одна
контакт: контакты
мочь: могу
web: web
беззнаковый: беззнаковое
переезжать: переехал
error: error
вывод: выводе вывод
война: война
скомпроментированный: скомпроментирован
аптайм: аптайм
день: дня
е: е
рано: раньше
разный: разные
ситуация: ситуациях
отдавать: отдает отдать отдавать
обзор: обзор
наверняка: наверняка
ос: ос
существенно: существенно
сортировка: сортировка
минимизировать: минимизировать
спасибо: спасибо
tl: tls
откуда: откуда
никак: никак
подводить: подвела
организовывать: организовать
секрет: секрет
бесплатный: бесплатные
нарезать: нарезать
глянуть: глянуть
забывать: забывайте
атавизм: атавизмом
ин: ин
нормально: нормально
fastvps: fastvps
рии: рии
часто: часто
предоставлять: предоставляет
лишний: лишний
medium: medium
опасность: опасность
service: service
бесконечный: бесконечная
нуж: нуж
проксировать: проксировать
коммит: коммитов
ip: ip
доступ: доступ
общий: общем
ух: ух
small: small
ipv: ipv
открытый: открытому
примерно: примерно
хрен: хрен
keycaptcha: keycaptcha
целый: целых целый
весть: вести
dev: dev
чи: чи
ветка: веткой
framework: framework
требоваться: требуется
нужно: нужно
около: около
текст: тексте текста
основа: основа
прикручивать: прикрутить
progressive: progressive
подпись: подпись
думать: думаю
преобразовывать: преобразовывать
почему: почему
обратно: обратно
мыс: мыс
ссылка: ссылки
динамичный: динамичны
ранее: ранее
утверждать: утверждающий
сделать: сделать
очевидно: очевидно
функция: функции
состоять: состоит
несомненно: несомненно
веб: веб
график: графике
косвенно: косвенно
ненужный: ненужные
письмо: письма
жестоко: жестоко
вобщий: вобщем
обращение: обращения
jjencode: jjencode
смена: смену
ме: ме
отличие: отличие
экономично: экономично
заставлять: заставляет
немой: нем
практически: практически
становиться: стал
актуальность: актуальностью
