женщина: женщина
галицкий: галицко галицкий
рекомендоваться: рекомендуется
e: e
пользователь: пользователи
глобализм: глобализма
англия: англии
сирия: сирии
андрей: андрей
кочевник: кочевники
мстиславич: мстиславич
фульвия: фульвия
широков: широкова
пакистан: пакистана
default: default
э: э
ю: ю
полный: полное
пилос: пилос
принцепс: принцепса
форум: форуме форум
главный: главная
идеальный: идеальная
казак: казаков
антропология: антропология
последний: последние последний
александра: александра
видео: видео
мать: матерью
смит: смит
rodoslovi: rodoslovi
общедоступный: общедоступных
крестовый: крестовый
средневековье: средневековья
ответ: ответов ответа
связь: связь связей
навигация: навигация
диск: диск
старый: старым
foliant: foliant
чжа: чжи чжу
проблема: проблеме
шарнина: шарнина
анализ: анализа
эллада: эллады
stari: stari
скандинавия: скандинавии
ский: ский
таис: таис
вымысел: вымыслы
кай: кая
публикация: публикации
принципат: принципата
н: н
русский: русский
колонизация: колонизации
константин: константина
творчество: творчества
австрия: австрии
егоров: егоров
римский: римского римской
оружейный: оружейная
парунин: парунин парунина
пастухов: пастухова
запоминать: запомнить
сайт: сайт сайту
царь: царя
валента: валента
фестский: фестский
гребенщиков: гребенщикова
аравия: аравии
древний: древние
головко: головко
обратный: обратная
межполисный: межполисных
защищать: защищены
jul: jul
запись: записи
пруссия: пруссию
империя: империи
snow: snow
р: р
чхунм: чхунму
рим: риме рима римом
спор: споры
академия: академия
тевтонский: тевтонский
факт: факты
стратег: стратега
португалия: португалии
стиль: стиль
польша: польши
матрона: матрона
харичкин: харичкин
младший: младший
везде: везде
жертва: жертва
политический: политическая политической
индия: индии
старший: старшая старший
english: english
умблоо: умблоо
яковлевич: яковлевич
песчаный: песчаный
уния: уния
плейлист: плейлисты
алексей: алексея алексей
филя: фили
индоевропейский: индоевропейская
вестгот: вестготы
харийс: харийс
галльский: галльской галльских
право: права
коростелин: коростелин
луций: луций
сунсин: сунсина
юргенева: юргенева
новый: новым нов
россия: россии
источник: источник
джеймс: джеймс
власть: власть
гибель: гибель
игра: игры
ljubomir: ljubomir
зарегистрировать: зарегистрированы
майор: майоров
блог: блогах блоги
фурия: фурия
страна: стран
греко: греко
италия: италии
испания: испании
эдикт: эдикт
community: community
закономерный: закономерное
очерк: очерк
жугуа: жугуа
кавказ: кавказа
совет: совет
уезд: уезда
тема: темы
византийский: византийско
oct: oct
япония: японии
распад: распада
бог: богов
отношение: отношения отношениях
язык: язык
сенека: сенека
software: software
весь: вся
г: г
рорик: рорик
хазанов: хазанов
гон: гон
фактор: фактор
стратегический: стратегическая
миланский: миланский
волынский: волынского
фольк: фольк
попов: попов
византия: византии
мильтиада: мильтиад
циркин: циркин
николай: николай николая
заговор: заговор
поэт: поэты
друг: друзей друзья
епископ: епископ
файл: файлы
описание: описание
гомера: гомера
падение: падение
комендант: коменданта
z: z
план: планы
балканы: балкан
м: м
usa: usa
октавия: октавия
революция: революции
зеркало: зеркало
конфликт: конфликта
сражение: сражение
мах: махов
британский: британский
администрация: администрация
анонимно: анонимно
даниил: даниил
сидоров: сидорова
переходить: перейти
red: red
славнитский: славнитский славнитского
ru: ru
система: систему системе
македонский: македонского
зарапин: зарапин
история: история
малый: малой
клеймо: клейм
автор: авторы автор
деция: деций
вьетнам: вьетнам
пилипчук: пилипчук
кампания: кампания
istorja: istorja
jan: jan
договорный: договорные
неформальный: неформальных
голландия: голландии
назад: назад
бактрийский: бактрийской
летописный: летописный
сергей: сергей
аудио: аудио
век: век
б: б
бондфилд: бондфилд
первый: первая
сестра: сестра
эмансипация: эмансипации
миротворческий: миротворческий
жизнь: жизни
родосский: родосского
гэд: гэда
географич: географиче
возрождение: возрождения
фаня: фань
srpski: srpski
династия: династия
маргарет: маргарет
эпоха: эпоху
иран: ирана
корея: кореи
император: император императора
боголепный: боголепный
лужа: луже
балканский: балканская
сеть: сети
правление: правление
позднеримский: позднеримской
интеграция: интеграция
соцсеть: соцсетях
nov: nov
князь: князь
гипатия: гипатия
балтийский: балтийской
общий: общей
r: r
содержимый: содержимому
архивариус: архивариус
создание: создание
умолчание: умолчанию
колониальный: колониальное
политика: политике политика
д: д
китайский: китайского
inc: inc
адрианополь: адрианополем
франция: франции
клавдия: клавдия
венгрия: венгрии
рекорд: рекорд
правило: правила
hoplit: hoplit
дневник: дневник
полинезия: полинезии
центральный: центральной
цезарь: цезаря
letopisi: letopisi
куликов: куликова
сибирь: сибири
избранный: избранное
apr: apr
ярослав: ярослав
invision: invision
забывать: забыли
китай: китая
венгерс: венгерс
скит: скит
пароль: пароль
портнягина: портнягина
деятельность: деятельность
feb: feb
октавиан: октавиана
компьютер: компьютерах
ютландский: ютландский
активность: активность
вместе: вместе
юрий: юрия
рекуай: рекуай
египет: египта
палестина: палестины
синезия: синезий
олимпийский: олимпийские
попытка: попытка
service: services
африка: африки
п: п
свенцицкая: свенцицкая
княжество: княжества
армия: армии
оргиофант: оргиофанты
чат: чат
чонсо: чонсо
тиберий: тиберия
азия: азии
блейн: блейн
гаплогруппа: гаплогруппа
разбор: разбор
концепция: концепция
русь: руси
dec: dec
потоп: потопы
внешний: внешний
семья: семья
афинский: афинская
бушевать: бушуете
проксения: проксения
яман: яманов
белкин: белкин
историко: историко
гора: горах
мир: мир миром
авит: авит
тобол: тобол
кузищин: кузищин
монархия: монархии
плавание: плавания
вержбицкий: вержбицкий
италинский: италинский
бельгия: бельгии
показывать: показать
юва: юва
страница: страница страницы
цин: цин
война: войн война
категория: категории
собрание: собрание
пастух: пастухов
ярыгин: ярыгин
аудиотека: аудиотека
прилуцкий: прилуцкий
л: л
держава: державы
сеять: сеяна
воспитание: воспитания
лавка: лавка
просмотр: просмотров
power: power
суслопаров: суслопарова
е: е
языковой: языковая
птолемаидский: птолемаидский
агриппина: агриппина
kusaloss: kusaloss
лемминг: лемминг
фильм: фильма
прошлое: прошлое
чевенгурский: чевенгурского
роман: роман
впирать: впер
важный: важнейший
варвар: варварами
кристина: кристина
общество: общество
документ: документов
войтович: войтович
ранний: ранней
евражкин: евражкин
рунг: рунг
орден: орден
полинезиец: полинезийцев
античный: античная
чжан: чжан
сексуальный: сексуальный
джозеф: джозеф
чжао: чжао
туманс: туманс
stojanovic: stojanovic
pro: pro
поиск: поиск
расширять: расширенный
тетрадь: тетради
хистори: хистори
конфиденциальность: конфиденциальности
калмыков: калмыков
военный: военно
лента: лента
общественный: общественных
пржигодзский: пржигодзская
самовоспитание: самовоспитания
греческий: греческой
единорог: единорог
месопотамий: месопотамии
входить: войти
дебют: дебют
поражение: поражение
лущая: лущая
императорский: императорского
saygo: saygo
америка: америки
финляндия: финляндии
иноземный: иноземных
webmoney: webmoney
sep: sep
обращение: обращение
эллинистический: эллинистической
анно: анней
рюрик: рюрик
ментор: ментора
помощь: помощь
кодекс: кодекс
календарь: календарь
поход: поход
германия: германии
ошибка: ошибка
p: p
