многодетный: многодетным
скайп: скайп
ваш: ваше ваши вашему ваш
рф: рф
подробно: подробнее
врач: врачу врачи врача
вернуться: вернуться
другой: другого
пункт: пункте
balticpearl: balticpearl
обязательный: обязательный
акция: акции
связь: связь
консультация: консультация консультацию консультации
жалоба: жалобы
дом: дом дому
это: это
круглосуточный: круглосуточная
адрес: адрес
рекомендовать: рекомендуем
телефон: телефону телефон телефона
мы: нами
mail: mail
мера: меры
прием: прием
обслуживание: обслуживания
лично: лично
соответствующий: соответствующего
ежедневный: ежедневный
местный: местное местному
центр: центр центре
район: районам
город: город городом города
медицинский: медицинского медицинском медицинский медицинской
главный: главная
круглосуточно: круглосуточно
отчество: отчество
полный: полной
обработка: обработки
работать: работает работают
завершать: завершить
произвольный: произвольной
платный: платная платной платную
пенсионер: пенсионерам
одышка: одышка
курс: курса
бактерицидный: бактерицидные
версия: версии
здоровый: здоровы
обращаться: обратитесь
контакт: контакты
наш: наш наши нашем наша
пользователь: пользователей
пациент: пациенту
программа: программы
заявка: заявки
петербург: петербург
трибуц: трибуца
причина: причину
почта: почты почта
позвонить: позвонив
делать: делаем
данный: данных
коридор: коридоре
адмирал: адмирала
вводить: введите введены
администратор: администратора
температура: температура
поддержка: поддержки поддержка
относиться: относятся
услуга: услуги
medicalcenter: medicalcenter
начинать: начать
основной: основные
проживать: проживаете
форма: форме
дача: даче
проходить: проходят
отъезд: отъезде
стоять: стоит
страна: страны страну
опыт: опыт
внимательно: внимательно
политика: политикой политика
современный: современный
документ: документы
страховка: страховки
д: д
далеко: далеко
все: всем
время: время времени
доктор: доктор
дома: дома
запись: запись
согласный: согласен
оставаться: оставайтесь останетесь
выходить: выходя
код: кодом
удобный: удобное удобную
личный: личный
сша: сша
устаревать: устарел
спасибо: спасибо
спб: спб
находиться: находитесь
последний: последние последней
опрос: опроса
затруднять: затруднено
санкт: санкт
комфортный: комфортного
получать: получить
персональный: персональных
вход: вход
прайс: прайс
перезванивать: перезвоним
звонить: звоните
приходить: прийти
рабочий: рабочего
безопасность: безопасности
обновление: обновление
текущий: текущее
альтернативный: альтернативное
специальный: специальные
пожалуйста: пожалуйста
лист: лист
сотрудник: сотрудник
лампа: лампы
мнение: мнение
выезд: выезд
дезинфицирующий: дезинфицирующие
сам: самого
кабинет: кабинетах
довольный: довольны
вс: вс
момент: момент
помогать: поможем
качественный: качественного
мочь: можете
ленобласть: ленобласти
связываться: свяжитесь
skype: skype
давать: дадим
постоянно: постоянно
платформа: платформе
восстановление: восстановления
специалист: специалиста специалисты специалистов
населенный: населенном
течение: течение
номер: номер
портал: портал
указывать: укажите
омоложение: омоложения
ул: ул
дата: дату
ru: ru
почему: почему
использовать: использовать
евросоюз: евросоюзе
имя: имя
большой: большой
осмотр: осмотр
удобно: удобно
заполнение: заполнения
посещение: посещение
каждый: каждый каждому
сайт: сайта
продолжать: продолжить
заказ: заказе
обновлять: обновить
предварительно: предварительно
чувствовать: чувствовали
описывать: опишите
электронный: электронной электронная
завершение: завершения
фамилия: фамилию
скидка: скидки
помощь: помощью
выбирать: выбрать
хотеть: хотите
иметь: имеют
браузер: браузер
нажимать: нажмите
доброжелательность: доброжелательность
заболеть: заболели
работа: работы
кашель: кашель
