свежий: свежие
россия: россии
суть: сути
сходить: сходить
население: населения
обычно: обычно
рождение: рождения
ребенок: ребенка детьми детей дети ребенком детях
врач: врачу
являться: является
информация: информация
это: это
комбинезон: комбинезон
сайт: сайте
день: день
характер: характер
беременность: беременности беременность
важно: важно
ответственность: ответственность
подросток: подростки
здоровье: здоровья
twitter: twitter
который: котором
город: город городов
неудивительный: неудивительно
любой: любым
форум: форум форума
жительница: жительницы
тема: темы
протекать: протекала
численность: численности
входить: входит
ответ: ответ ответа
человек: человек
vk: vk
развлечение: развлечений
наш: наша
информационно: информационно
больший: большая
такой: такое
малыш: малышей
слип: слип
детский: детский
многие: многие
красить: красить
москва: москве
развлекательный: развлекательный
организационный: организационные
политика: политика
волгоград: волгоград волгограде
ознакомительный: ознакомительный
отмечать: отметить
роды: роды
оферта: офертой
хлопоты: хлопоты
брать: берем
дарья: дарья
поэтому: поэтому
челябинск: челябинск челябинске
эмоция: эмоции
казань: казани казань
радость: радость
рубрика: рубрики
последний: последние
маленький: маленькие
беременный: беременных
незабываемый: незабываемые
новорожденный: новорожденные новорожденного
миллион: миллиона
год: год
проживать: проживает
признак: признаки
легкий: легкой
волос: волосы
полезный: полезное
первый: первые
специальный: специальный
большинство: большинства
публичный: публичной
обязательно: обязательно
перинатальный: перинатальные
запись: записи
поиск: поиск
крупный: крупный
искать: ищут
слитный: слитный
mychilds: mychilds
конфиденциальность: конфиденциальности
вопрос: вопросам
петренко: петренко
сотрудничество: сотрудничество
носов: носова
портал: портал
читать: читать
ваш: ваша
переходить: перейти
меню: меню
нести: несет
находить: найдено
п: п
платный: платные
проект: проекте
весь: всей
курсы: курсы
обращаться: обращайтесь
далее: далее
назад: назад
ткань: ткани
разный: разное
разнообразие: разнообразие
илья: илья
ольга: ольга
команда: команда
закрывать: закрывает
среди: среди
мама: мам
топ: топ
