email: email
api: api
web: web
canonical: canonical
wordstat: wordstat
code: code
jcat: jcat
team: team
ru: ru
q: q
e: e
product: product
cy: cy
html: html
integer: integer
bigtime: bigtime
ssl: ssl
seo: seo
line: line
cm: cms
ip: ip
ant: ant
en: en
february: february
mail: mail
http: http
chrome: chrome
review: reviews
reaspekt: reaspekt
venture: ventures
c: c
update: update
loading: loading
express: express
siniakin: siniakin
pdf: pdf
whois: whois
su: su
pug: pug
linkbuilder: linkbuilder
pr: pr
google: google
