пирог: пирог
дрожжевой: дрожжевые
виктория: виктория
подсказывать: подскажет
кабачок: кабачков
судак: судак
секрет: секретом
фотография: фотографиями фотографии
овощ: овощами
пара: пару
частичный: частичная
пошаговый: пошаговыми
соус: соусе соус соусом
суп: суп
кулинарный: кулинарных кулинарные кулинарного
say: say
быть: будете
сайт: сайт сайте сайта
филе: филе
имбирный: имбирные
рассылка: рассылки рассылка
группа: группах
закуска: закуски
торт: торты торт
запрещать: запрещена
праздничный: праздничные
помогать: помогут
свекла: свеклой
фасоль: фасолью
морепродукт: морепродукты
аджика: аджике
сыр: сыром
форум: форумы форума
салат: салат салаты
рецепт: рецептов рецептами рецепты
миллион: миллионы
одноклассник: одноклассники
это: этим
находить: найдете
яблочный: яблочный яблочные
сгущать: сгущенном
посмотреть: посмотреть
интересный: интересные
подробный: подробными
мой: моего
сэндвич: сэндвич
язык: язык
оладья: оладьи
право: праве
грибной: грибном
спаржа: спаржей
ягода: ягодой
новый: новыми новые
автор: авторе
запекать: запеченная запеченные
курица: курица
несладкий: несладкая
куриный: куриным куриные
задумываться: задумываются
текст: тексты
кедровый: кедровыми
решать: решить
инструкция: инструкциями
белый: белыми
напиток: напитки
песто: песто
рыба: рыба
заправка: заправкой
вяленый: вяленой
блин: блины
наш: наших нашего
руккола: рукколой
вконтакте: вконтакте
мариновать: маринованный
опубликовывать: опубликованной опубликованные
молоко: молоке
первый: первые
вопрос: вопросом вопрос
второй: вторые
месяц: месяц
защищать: защищены
наршараб: наршараб
ежедневно: ежедневно
бриошь: бриошь
крем: крем
info: info
черри: черри
любимый: любимые
информация: информации
следить: следить
оссобуко: оссобуко
мочь: можете
самый: самые
вишня: вишней
человек: людей
перепечатка: перепечатка
авторский: авторском
гриб: грибами
тефтели: тефтели
семифредо: семифредо
сегодня: сегодня
бутерброд: бутерброды
получать: получать
кобб: кобб
десерт: десерты
сливочный: сливочно сливочным
закон: законом
инстаграм: инстаграм
брюле: брюле
орешек: орешками
крылышко: крылышки
мороженое: мороженое
subscribe: subscribe
выпечка: выпечка
все: всему
любой: любая
тыква: тыквой
повседневный: повседневные
приготавливать: приготовить
топленый: топленом
омлет: омлет
апельсиновый: апельсиново
надеяться: надеюсь
блюдо: блюда
рулька: рулька
гавайский: гавайская
вафля: вафли
несколько: несколько
йогуртовой: йогуртовой
творожный: творожным
разный: разное
пирожное: пирожные
фаршированный: фаршированные
картофель: картофелем
сырник: сырники
мир: миру
полный: полная
утиный: утиным
пицца: пицца
