камин: камины
спальный: спальные
тц: тц
дерево: дерева
скидка: скидок
сборка: сборка
задавать: задать
стол: стол столы стола
добро: добро
калининград: калининград калининграда калининграде
диван: дивана диваны диван
офисный: офисные офисную
ломать: ломать
tropicana: tropicana
акция: акции
компания: компании
приветливый: приветливый
красивый: красивый
vera: vera
это: это
быстро: быстро
привлекательный: привлекательную
пуфик: пуфики
прихожая: прихожие прихожей
представлять: представлена
именно: именно
carlo: carlo
прямой: прямые прямой
социальный: социальных
корпусной: корпусная
мягкий: мягкие мягкая мягкой
столь: столь
салон: салоны салонов салонах салон
двухъярусный: двухъярусная двухъярусные
обеденный: обеденный
раздел: разделе
гостиная: гостиную гостиные
актуальный: актуальную
учитывать: учитываем
vicento: vicento
мебель: мебели мебелью мебель
главный: главная
уголок: уголки
гарнитур: гарнитур гарнитуры
сайт: сайт
работа: работы
награда: награды
домашний: домашняя
московский: московский
туалетный: туалетные
покупатель: покупателей покупателям
corsica: corsica
сеть: сетей сети сетях
видео: видео
часы: часы
компьютерный: компьютерные
посмотреть: посмотреть
спальня: спальню спальни
рассрочка: рассрочку
страница: страница
наш: наших наши нашем
youtube: youtube
режим: режим
декоративный: декоративные
stillo: stillo
персонал: персонал
один: одной
дизайн: дизайн
отзыв: отзывы
пожелание: пожелания
посуда: посуды
предложение: предложения
й: й
пт: пт
vk: vk
сб: сб
хороший: лучшие лучший
калининградский: калининградской
знать: знают
данный: данных
капитал: капиталу
тумба: тумба тумбы
зеркало: зеркала
uno: uno
duo: duo
многие: многие
whatsapp: whatsapp
г: г
выбор: выбором
востребовать: востребованную
телефон: телефоны
качалка: качалки
amarella: amarella
видеть: видеть
корзина: корзина
кабинет: кабинета
тв: тв
новое: новое
журнальный: журнальные
новость: новости
marco: marco
стенка: стенку стенки
доставка: доставка
ассортимент: ассортимента
официальный: официальный
проходить: проходят
кухня: кухни
политика: политика
первый: первую
donte: donte
modo: modo
современный: современная
покупать: покупают
комплект: комплект комплекты
купить: купить
согласие: согласие
детская: детская
данные: данные
дома: дома
милан: милан
электрический: электрические
магазин: магазин магазине магазинов
свой: своих своего
телевизор: телевизор
секрет: секрет
персональный: персональных
материнский: материнскому
кровать: кровать кровати
долгий: долгое
проспект: проспект
детский: детских
отличный: отличное отличную
барный: барные
maxim: maxim
стул: стулья стульев
большой: большого
прикроватный: прикроватные
прод: прода
различный: различная
пенал: пеналы
регулярно: регулярно
столовая: столовой
momento: momento
очередь: очередь
столик: столики
шкаф: шкаф шкафы
кухонный: кухонный
помогать: помочь
купе: купе
система: система
коллектив: коллектив
мнение: мнение
публичный: публичной
аллоро: аллоро
готовый: готовые
полка: полки
кресло: кресло кресла
этаж: этаж
уважение: уважением
известный: известнейших
вс: вс
гарантия: гарантия
поиск: поиск
каталог: каталог каталоге
истинный: истинные
bari: bari
ценить: ценим
одежда: одежды
интернет: интернет
м: м
искать: искать
пн: пн
обработка: обработку
гиант: гиант
конфиденциальность: конфиденциальности
бамбук: бамбука
мочь: можете
договор: договор
мебельный: мебельный мебельных
milan: milan
строиться: строится
напольный: напольные
вопрос: вопрос
постоянный: постоянных
региональный: региональному
подушка: подушки
также: также
комод: комоды комод комода
оферта: оферты
возникать: возникает
дело: дела
стекло: стекла
подарочный: подарочные
нужно: нужно
клиентопретензия: клиентопретензия
сотрудничество: сотрудничество
книжка: книжки
картина: картины
выгодно: выгодно
вакансия: вакансии
cappuccio: cappuccio
угловой: угловые угловой
поступление: поступление
ru: ru
стеллаж: стеллажи
ч: ч
еврокнижка: еврокнижки
цена: цене
stellarina: stellarina
меню: меню
удовольствие: удовольствием
уход: уход
офис: офиса
контактный: контактные
адрес: адреса
клиент: клиентов
kanet: kanet
copyright: copyright
действовать: действует
голова: голову
приобретать: приобрести
распродажа: распродажа
facebook: facebook
кроме: кроме
область: области
долго: долго
viber: viber
прокручивать: прокрутить
выбирать: выбрать
пуф: пуфы
знаток: знатоки
гостин: гостиных
iga: iga
вешалка: вешалки
кредит: кредит
пожаловать: пожаловать
рад: рады
наверх: наверх
соответствующий: соответствующем
сертификат: сертификаты
книжный: книжные
