подсказывать: подскажет
ваш: вашего ваших
добро: добро
выставка: выставки выставку
изучать: изучить
музей: музеям музеи музеев музей
принимать: принимаете принять
коллекция: коллекции коллекцию
картина: картину картин
копия: копии
slovenski: slovenski
работа: работы работ работу
добавлять: добавить
ключевой: ключевые
согласно: согласно
language: language
cookie: cookie
опубликовывать: опубликовать опубликуйте
заказ: заказ
слово: слова
покупать: покупайте
любимый: любимых
нськ: нська
новый: новых новый
какой: какие
произведение: произведения произведений произведение
артхив: артхив артхивом артхива
знание: знания
максимум: максимум
crm: crm
галерея: галереи галереям галерею галерей
сайт: сайт
телеграм: телеграма
загружать: загрузите загрузить
создавать: создать создайте
продавать: продать
мой: мои
приложение: приложения
список: список
портфолио: портфолио
покупатель: покупателей
deutsch: deutsch
собирать: собираем соберите
ai: ais
видео: видео
версия: версии
продажа: продажами
espa: espa
страница: страница страницу
наш: наш наши
сюда: сюда
аннотация: аннотациями
пользоваться: пользуйтесь
быстрый: быстрый
язык: язык языке
маркетплейс: маркетплейс
задавать: задаваемые
старый: старые
статья: статью
медиум: медиуме
данный: данных
публикация: публикации публикацию
художник: художники художникам художников художника
современный: современные современных
анализ: анализа
новость: новости
артхива: артхиве
политика: политика
пользователь: пользователя пользователям
создание: создания
функция: функций
реклама: реклама
выбирать: выберите
русский: русский
fran: fran
данные: данные
арт: арт
продукт: продукты
удобный: удобное удобном
изображение: изображение
сервис: сервисы
коллекционер: коллекционерам
устройство: устройства
ol: ol
android: android
число: числе
энциклопедия: энциклопедия
интерес: интересов
чат: чатах
часто: часто
залогиниться: залогиньтесь
arthive: arthive
выставочный: выставочных
цифровой: цифровые
файл: файлы
использовать: использовать используем используя
мобильный: мобильные
вводить: введите
pro: pro
поиск: поиск
мастер: мастера
песочница: песочница
конфиденциальность: конфиденциальности
справочник: справочник
мочь: можете
продвижение: продвижение
заказывать: заказать
входить: войдите войти
также: также
находить: найти
возможность: возможности возможностей
faq: faq
управление: управление управления
условие: условия
искать: искали
дебют: дебют
аудиогид: аудиогидами
подборка: подборки
вакансия: вакансии
english: english
перетаскивать: перетащите
клиент: клиентами
известный: известных
худодников: худодников
сеть: сетях
io: ios
помогать: поможет
контент: контента
напрямую: напрямую
ранее: ранее
цена: цены
контактный: контактные
показ: показы
аккаунт: аккаунт
укр: укра
проект: проектов проекте
помощь: помощь
italiano: italiano
любитель: любителям
искусство: искусства
основа: основе
узнавать: узнать
свой: свои
открывать: откройте
рекламный: рекламного
вопрос: вопросы
бесплатно: бесплатно
пожаловать: пожаловать
тест: тесты
бот: бот
который: которым
