свежий: свежие
цвет: цвет
бензиновый: бензиновых
снижать: снизить
топ: топ
составлять: составляет
известный: известного
продолжать: продолжая
detector: detector
заводской: заводской
автомобиль: автомобилем автомобиль автомобиля автомобиле
разновидность: разновидности
топливо: топлива топливо
схема: схема
форд: форд
фьюжн: фьюжн
хендай: хендай
конструкция: конструкции
файл: файлами
спортейдж: спортейдж
являться: является
ранний: раннее
неисправность: неисправность неисправностей
adblock: adblock
cookie: cookie
отличаться: отличается
сайт: сайт сайте сайта
простота: простотой
подробно: подробно
причина: причин причиной
себя: собой
автомобильный: автомобильный
фургон: фургона
поколение: поколениям
карта: карта
детонация: детонация
главный: главная
холл: холла
км: км
литр: литров
хранение: хранения
киа: киа
положение: положениях
повышенный: повышенного
знать: знать
показатель: показатели
матиз: матиз
создавать: создать
пробег: пробег пробега
первый: первых
топливный: топливного топливных
расход: расхода расход расходе
показывать: показать
способ: способы
передавать: передает
контакт: контакты
модель: моделям
проба: проб
компонент: компонентов
коленвал: коленвала
народный: народного
vk: vk
система: система системы
поздно: позднее
л: л
рав: рав
свеча: свечи свечей
десяток: десятка
километр: километров
фокус: фокус
норма: норма
данный: данных
транзит: транзит
ремонт: ремонт
сопротивление: сопротивление
зажигание: зажигание зажигания
весь: вся
поломка: поломки
превышать: превышает
современный: современный
официальный: официальный
назначение: назначение
проверка: проверка
публикация: публикации
сенсор: сенсор
согласие: согласие
все: всем
данные: данные
эффективный: эффективные
вид: виды
авто: авто
признак: признаков
охлаждающий: охлаждающей
низкий: низкой
каков: каков
актуальный: актуален
обнаружение: обнаружения
этот: этими
электроника: электроника
диагностика: диагностика
рено: рено
газ: газ
себестоимость: себестоимостью
ok: ok
полезный: полезное
крайний: крайних
устранение: устранения
дастер: дастер
ещ: ещ
защищать: защищены
означать: означает
сам: самого
свое: свое
рио: рио
забивать: забитого
ваз: ваз
автоваз: автоваза
изменять: изменяет
параметр: параметры
жидкость: жидкости
термистор: термистор
пора: пора
температура: температуры
правда: правда
самый: самые
определять: определить
результат: результатам
усреднять: усредненном
находить: найти
реальный: реальный
катушка: катушке
нужно: нужно
шесть: шесть
соул: соул
логан: логан
определяться: определяются
сегодня: сегодня
срабатывать: срабатывает
давать: даете
нива: нивы
цикл: цикле
коммерческий: коммерческого
использовать: использовать использует
работа: работы работу
версия: версиях
газель: газели
экономия: экономии
зависимость: зависимости
метод: методы
анализ: анализ
датчик: датчик
популярный: популярные
солярис: солярис
один: одна
корректировка: корректировки
форсунка: форсунок
принцип: принцип
право: права
условный: условном
оптима: оптима
менять: менять
фильтр: фильтра
представлять: представляет
тойота: тойота
дэу: дэу
двигатель: двигателя
