нос: носу носа
невролог: невролог невролога
щитовидный: щитовидной
акушер: акушер
офтальмолог: офтальмолог
сифилис: сифилиса
бужирование: бужирование
анальный: анальной
честный: честный
диагностика: диагностика диагностики
специалист: специалистами специалист
гематолог: гематолог
анестезиолог: анестезиолог
э: э
пилинг: пилинг
круглосуточный: круглосуточный
хромоцистоскопия: хромоцистоскопия
телефон: телефону
характер: характер
искать: ищу
паравертебральный: паравертебральная
запрещать: запрещено
медицинский: медицинские медицинских
карта: карты карта
гомеопат: гомеопат
гинекология: гинекология
работать: работают
репродуктолог: репродуктолог
дозировать: дозированной
проконсультироваться: проконсультироваться
дуплексный: дуплексное
камень: камней
уретра: уретры
кровоток: кровотока
пользователь: пользователей
решение: решения
пациент: пациенту пациентов пациента
т: т
головной: головного
уролог: уролог
верхний: верхней
кишка: кишки
mosmedportal: mosmedportal
регистрация: регистрацию
хороший: лучшие
железа: железы
коррекция: коррекция коррекции
психиатр: психиатр
оферта: офертой
рентген: рентген
нижний: нижних
проктолог: проктолог
фиброаденома: фиброаденомы
криомассаж: криомассаж
кольцо: кольцами
н: н
врач: врачи врача врачам врачу врачей врач
половой: полового
срочный: срочная
рейтинг: рейтинг
нейрохирург: нейрохирург
травматолог: травматолог
сперма: спермы
замена: замены
ребенок: детей
необходимый: необходима
статический: статическая
администрация: администрации администрация
полисомнография: полисомнография
крайний: крайней
диетолог: диетолог диетолога
маточный: маточно
алалия: алалии
нога: ног
консультация: консультации
публиковать: публикуем
мануальный: мануальный
синус: синус
венерология: венерология
онколог: онколог онколога
защищать: защищены
зуб: зубы
варикозный: варикозных
мягкий: мягких
р: р
прерывать: прервать
инфекционист: инфекционист
маммология: маммология
венеролог: венеролог венеролога
мочь: можете мочи
эндокринолог: эндокринолог эндокринолога
справочник: справочники справочник
носить: носят
оценочный: оценочными
горбинка: горбинки
липофилинг: липофилинг
процедура: процедурам процедур
терапевт: терапевт
лазерный: лазерная
эндоскопический: эндоскопическое
дарсонвализация: дарсонвализация
занятие: занятие
контагиозный: контагиозного
иссечение: иссечение
эндоскопия: эндоскопия
климакс: климакса
кукушка: кукушка
проект: проекта проекте
лекарственный: лекарственных
уздечка: уздечки
письменный: письменного письменной
непосредственный: непосредственной
ткань: тканей
простата: простаты
право: права
хотеть: хотите
записываться: записалось записаться
который: которые
липосакция: липосакция
позвоночник: позвоночника
флебология: флебология
промывание: промывание
ф: ф
сексолог: сексолог сексолога
эко: эко
железо: желез
цена: цены ценами
рэг: рэг
фиброма: фибромы
мониторирование: мониторирование
фониатр: фониатр
фототрихограмма: фототрихограмма
пародонтит: пародонтита
развертывать: развернуть
маммолог: маммолога маммолог
вена: вен
реальный: реальных
сервис: сервисе сервиса сервис
ультрозвуковой: ультрозвуковая
внутренний: внутренних
трахеобронхоскопия: трахеобронхоскопия
использовать: использованная
микрофлебэктомия: микрофлебэктомия
трихолог: трихолога трихолог
поиск: поиска
термография: термография
ксантелазм: ксантелазм
джесснер: джесснера
нарушение: нарушений
отзыв: отзывы
микроэлемент: микроэлементы
сомнолог: сомнолог
химический: химический
мочка: мочки
реоэнцефалография: реоэнцефалография
стоматолог: стоматолог
html: html
клетка: клетки
лакуна: лакун
логопед: логопеда логопед логопедом
свищ: свища
спермограмма: спермограмма
стапедопластика: стапедопластика
вертебролог: вертебролог
г: г
весь: весь вся
моллюск: моллюска
материал: материалов
контурный: контурная
допплерография: допплерография
психотерапевт: психотерапевт
дерматология: дерматология
присоединяться: присоединяйся
резекция: резекция
трепанобиопсия: трепанобиопсия
транскраниальный: транскраниальное
средство: средств
артроскопия: артроскопия
уха: уха
физкультура: физкультура
клиника: клиниках клиникам клиники клиник
дерматовенеролог: дерматовенеролога
капилляр: капилляров
артериальный: артериального
радиотермометрия: радиотермометрия
получать: получена
электроэнцефалография: электроэнцефалография
сухой: сухое
массаж: массаж
мочевой: мочевого
информационный: информационным
давление: давления
лор: лор
публичный: публичной
гинеколог: гинеколог
кольпоскопия: кольпоскопия
вкладка: вкладки
эзофагогастродуоденоскопия: эзофагогастродуоденоскопия
склеротерапия: склеротерапия
спортивный: спортивный
иммунолог: иммунолог
м: м
электронейромиография: электронейромиография
нарколог: нарколог
рентгенолог: рентгенолог
сосуд: сосудов
неонатолог: неонатолог
проверять: проверенные проверенных
подолог: подолог
ретейнер: ретейнеры
любой: любое
эндокринология: эндокринология
молочный: молочной молочных
использование: использование использовании
ru: ru
заболевание: заболеваний
миндалина: миндалин
сустав: суставов
лицо: лица
сайт: сайта сайте
узел: узлов
аудиометрия: аудиометрия
являться: являются
кал: кала
функциональный: функциональная функциональной
бронхоскопия: бронхоскопия
гепатолог: гепатолог
эхокг: эхокг
открытый: открытых открытый
окулист: окулист
сигмовидный: сигмовидной
основа: основе
киста: кисты
ангиография: ангиография
трихограмма: трихограмма
онкодерматолог: онкодерматолог
аденома: аденомы
плоть: плоти
отоларинголог: отоларинголог
матка: матки
электрокардиография: электрокардиография
папиллома: папиллом
лазер: лазером
подмосковье: подмосковья
септопластика: септопластика
фтизиатр: фтизиатр
лифтинг: лифтинг
голова: головы
беременность: беременности
прессотерапия: прессотерапия
генетик: генетик
приводить: приведенные
круглосуточно: круглосуточно
кава: кава
флеболог: флеболог
список: список
операция: операция
кариес: кариеса
холтер: холтеру
конечность: конечностей
брахиоцефальный: брахиоцефальных
источник: источников
нефролог: нефролог нефролога
продувание: продувание
проба: пробы
страница: страницам
биопсия: биопсия
редакция: редакции
бесплатный: бесплатные бесплатный
эхокардиография: эхокардиография
физический: физической
логопедия: логопедия
полость: полости
контактный: контактная
услуга: услуги
сурдолог: сурдолог
мы: нам
прямой: прямой
принятие: принятия
артролог: артролог
д: д
урология: урология
нагрузка: нагрузкой
мрт: мрт
кровь: крови
лечение: лечение
запись: записью запись
анус: ануса
циркумцизио: циркумцизио
правило: правила
лигирование: лигирование
химиотерапевт: химиотерапевт
секрет: секрета
орган: органов
винкельман: винкельмана
андролог: андролог
вконтакте: вконтакте
опубликовывать: опубликованная опубликованные
паразитолог: паразитолог
пластика: пластика
небный: небных
отношение: отношения
энмг: энмг
политцер: политцеру
профилактика: профилактика
шейка: шейки
инсеминация: инсеминация
кость: костей
эпилептолог: эпилептолог эпилептолога
установка: установка
гастроскопия: гастроскопия
сканирование: сканирование
слуховой: слуховых
наш: наш
спектральный: спектральный
показывать: показываем
коагуляция: коагуляция
почка: почек
гормон: гормоны
позвонить: позвоните
пластический: пластический пластическая
реабилитолог: реабилитолог
ревматолог: ревматолог
латексный: латексными
труба: труб
дерматолог: дерматолог
п: п
суждение: суждениями
гименопластика: гименопластика
продолжать: продолжить
диабетолог: диабетолога диабетолог
вытяжение: вытяжение
аллерголог: аллерголог
микродермабразия: микродермабразия
ээг: ээг
колоноскопия: колоноскопия
кинезиолог: кинезиолог
вегетолог: вегетолог
педиатр: педиатр
шея: шеи
актуальный: актуальных
иметь: имеют
восстановление: восстановление
фильтр: фильтра
вопрос: вопросы
брюшной: брюшной
бровь: бровей
геморроидальный: геморроидальных
грудной: грудной
ортопед: ортопед
нефросцинтиграфия: нефросцинтиграфия
косметолог: косметолог
рефлексотерапевт: рефлексотерапевт
проктология: проктология
озонотерапия: озонотерапия
информация: информация
колопроктолог: колопроктолог
сфинктерометрия: сфинктерометрия
лфк: лфк
таз: таза
лечебный: лечебная
абатмент: абатментов
возникать: возникли
лимфоузел: лимфоузлов
ответственность: ответственности
бартолиновый: бартолиновой
член: члена
речь: речи
уздг: уздг
трещина: трещины
разрешение: разрешения
керат: кератом
неврология: неврология
гастроэнтеролог: гастроэнтеролог
л: л
косметология: косметология
кардиолог: кардиолог
пульмонолог: пульмонолог
москва: москвы москве
обрезание: обрезание
ознакомительный: ознакомительный
хирург: хирург
массажист: массажист
мозг: мозга
кроссэктомия: кроссэктомия
трихология: трихология
криоконсервация: криоконсервация
эндоскопист: эндоскопист
доктор: докторах
удаление: удаление
логопедический: логопедический
действительно: действительно
паращитовидный: паращитовидной
экг: экг
суточный: суточное
неокончательный: неокончательные
демодекс: демодекс
скула: скул
mac: macs
андрология: андрология
хирургия: хирургия
полип: полипов
ликвор: ликвора
стоматология: стоматология
водянка: водянке
кольпоперинеопластика: кольпоперинеопластика
керамический: керамические
находить: найти
радиоволновый: радиоволновое
узи: узи
анализ: анализы анализ
тимпанопластика: тимпанопластика
зппп: зппп
пузырь: пузыря
губа: губы
реовазография: реовазография
физиотерапевт: физиотерапевт
выбирать: выбирайте
хирургический: хирургическое
термолифтинг: термолифтинг
малый: малого
нести: несет
сцинтиграфия: сцинтиграфия
нейропсихолог: нейропсихолог
яичко: яичка
эпиляция: эпиляция
психолог: психолог
уретроскопия: уретроскопия
помощь: помощь
миколог: миколог
спирометрия: спирометрия
блокада: блокада
х: х
ресница: ресниц
плацентарный: плацентарного
придаток: придатка
заявка: заявка
рука: рук
кт: кт
гирудотерапевт: гирудотерапевт
ректороманоскопия: ректороманоскопия
гистероскопия: гистероскопия
остеопат: остеопат
волос: волос
