бородинский: бородинское
перестройка: перестройка
россия: россии
сталин: сталин
кровавый: кровавая
мемориальный: мемориальная
родственный: родственные
римский: римские
карибский: карибский
государство: государства
конфликт: конфликты
федорович: федорович
военный: военно военные
xx: xx
xix: xix
консул: консулы
кризис: кризис
чтение: чтения
поле: поле
геральдикум: геральдикум
неделя: недели
хронос: хронос хроноса
iv: iv
vii: vii
рюрик: рюрики
мспс: мспс
посещать: посещаемые
испания: испании
бестужев: бестужев
флоренский: флоренского
редактор: редактор
карта: карты карта
война: войны война
форум: форум
слово: слово
тема: темы
газета: газета
век: векам век века веке
александр: александр
год: году года годов
бельский: бельские
x: x
viii: viii
страница: страница страницы
петровна: петровна
таблица: таблицы
простор: просторы
библиотека: библиотека
vi: vi
революция: революция
заметка: заметки
распад: распада
v: v
флаг: флаги
гражданский: гражданская
преподавание: преподавания
правитель: правители
этноциклопедия: этноциклопедия
всемирный: всемирная
биографический: биографический биографические
платонов: платонова
введение: введение
гг: гг
хроника: хроника
лев: лев
архонт: архонты
г: г
герб: гербы
романовский: романовские
культура: культура
троцкий: троцкий
historia: historia
битва: битва
новость: новостей новости
молоко: молоко
е: е
документ: документы
франк: франков
иван: иван
подвиг: подвиг
исторический: исторические
xvi: xvi
этноним: этнонимы
иосиф: иосиф
xiv: xiv
хрущев: хрущеве хрущев
проект: проекты проект проектов
владимир: владимира
сибирский: сибирские
религия: религии
журнал: журнал
энциклопедия: энциклопедия
грозный: грозный
смута: смута
автор: авторы
интернет: интернете
роман: роман
петр: петр
афинский: афинские
общество: общество
материал: материалы
мировой: мировая
екатерина: екатерина
источник: источники
тематический: тематические
литературный: литературных
музей: музей
славянство: славянство
друг: друзей
статья: статьи
апсуар: апсуара
жизнь: жизнь
михаил: михаил
крестовый: крестовые
страна: страна страны
vitae: vitae
содружество: содружество
magistra: magistra
iii: iii
национальный: национальная
французский: французская
румянцев: румянцев
гитлер: гитлер
базарный: базарного
самый: самые
лента: лента
елизавета: елизавета
существовать: существует
цитирование: цитировании
труд: трудах
сражение: сражение
куликовская: куликовская
кожинова: кожинова
геосинхрония: геосинхрония
политический: политическая
предметный: предметный
огонь: огни
xviii: xviii
давать: давайте
рюмин: рюмин
философия: философия
наука: науки
мир: мира
ii: ii
методика: методика
папство: папства
xiii: xiii
xvii: xvii
румянцевский: румянцевский
никита: никита
поход: походы
px: px
шолохов: шолохов
указатель: указатель
история: история
создатель: создателей
русский: русская русское
ix: ix
п: п
сайт: сайта
подъем: подъем
xi: xi
xii: xii
газданова: газданова
хх: хх
ссср: ссср
популярный: популярные
хронология: хронология
вестник: вестник
январь: января
парус: парус
ссылка: ссылку
великий: великая
xv: xv
второй: вторая
византия: византия
полдень: полдень
гайто: гайто
вячеслав: вячеслав
адольф: адольф
твардовский: твардовский
вексиллография: вексиллография
генеалогический: генеалогические
первый: первая
est: est
