classic: classic
появляться: появится появилась появился
пользователь: пользователи
office: office
последний: последнее последний последнем
подробно: подробнее
western: western
евгений: евгений
шифрование: шифрованием
конкурент: конкурентов
аппарат: аппараты
дом: дом
гайд: гайды
интересный: интересное
chrome: chrome
полный: полное
оставаться: оставаясь
пустой: пустую
кодить: кодить
общий: общего общие
гейминг: гейминг
изменять: изменено
высокий: высоких
книга: книги
сталкиваться: столкнулись
отвечать: отвечать
готовить: готовит
рунный: рунное
наш: наши
компонент: компонентов
железо: железо
клавиатура: клавиатуры
соглашаться: соглашаетесь согласилась
указание: указанием
принадлежать: принадлежат
r: rss
температура: температуры температуру
новый: новых новыми новый новая
ноутбук: ноутбуки ноутбука
одночасье: одночасье
диск: диск
раздавать: раздавать
многие: многие
мобильный: мобильных мобильная мобильные
система: систем
хороший: лучших лучшие
новое: новое
преимущество: преимуществ
портировать: портировать
оферта: офертой
реклама: реклама
оригинальность: оригинальность
заимствование: заимствование
рейтинг: рейтинг рейтинги
android: android
денис: денис
процессор: процессор процессорах процессоров процессоры процессора
знак: знаком
получать: получить
нарушение: нарушением
материал: материалы
взять: взяла
оповещение: оповещение
задача: задач
комплектующий: комплектующих
передача: передачи
множество: множество
операция: операции
window: windows
данный: данных данном
интернет: интернет
обход: обход
увеличиваться: увеличивается
колонка: колонки
самый: самое самые
приложение: приложении приложения
платформа: платформе
строка: строку строки
цитирование: цитировании
обязательство: обязательство
мир: мира
переводчик: переводчики
планшет: планшеты
staff: staff
amd: amd
подборка: подборка
выпускать: выпустить
законодательство: законодательства
охлаждение: охлаждение
видеокамера: видеокамеры
внешний: внешние внешний
проект: проекте
игра: игра играми игры игр
водяной: водяным
панель: панель
здоровье: здоровье
память: памяти память
обзор: обзоры
звук: звук
мышь: мыши
согласие: согласия
будущий: будущие
nvidia: nvidia
программа: программ программы
безопасность: безопасность
уходить: уходит
который: которое которые который
игрок: игроков
поддержка: поддержкой
топ: топ
россия: россии
франшиза: франшизу
изображение: изображения
бот: бот бота
привносить: привнесло
включая: включая
производительность: производительности
мерка: меркам
мало: мало
консоль: консоли
видеокарта: видеокарт видеокарты видеокартах
cookie: cookie
fi: fi
twitter: twitter
понятно: понятно
аналитика: аналитика
оказываться: оказалось
монитор: мониторы
максимум: максимум
издание: издание
управление: управлению
телевизор: телевизоры
оборудование: оборудование
извлекать: извлечь
версия: версии
поиск: поиск поиска
минимальный: минимальных
шумоподавление: шумоподавлением
hi: hi
такой: такое
облачный: облачной
свой: свой
либо: либо
steam: steam
software: software
газонокосилка: газонокосилки
другой: другие другими других
поделиться: поделиться
разбухать: разбухший
сткий: сткий
борьба: борьбу
pencidesign: pencidesign
текст: тексты
angry: angry
pixel: pixel
обнаруживать: обнаружили
знаменитый: знаменитая
технология: технологий технологиях
файл: файлов файлами
телефон: телефонах
устройство: устройствами устройств устройства
случаться: случаются
камера: камер камеры
выходить: вышедшая
gigabyte: gigabyte
тестирование: тестировании
год: году года год
считаться: считается
популярный: популярный
гб: гб
браузер: браузеры
мочь: могут
оперативный: оперативной оперативная
продажа: продаже
вс: вс
дрон: дронами
какой: какую каких
нормальный: нормальной
встроенный: встроенный встроенного
анонсировать: анонсирован
международный: международного
локальный: локальной
activision: activision
рабочий: рабочие
nintendo: nintendo
powered: powered
tumblr: tumblr
плата: платы плата
сумасшедший: сумасшедших
возможность: возможность
тарасов: тарасов
digital: digital
страница: страницу
уметь: умеет
автор: авторам автор автора
патч: патч
microsoft: microsoft
являться: являются является
проверять: проверить
анонс: анонса
скорый: скором
ryzen: ryzen
накопитель: накопители
рекомендация: рекомендацией
покой: покой
намекать: намекает
специалист: специалистов
принтер: принтеры
o: os
hardware: hardware
быковский: быковский
неуклонно: неуклонно
lineageos: lineageos
геймер: геймеров
использование: использования использованием
представлять: представила представленные
сервис: сервисов
экосистема: экосистемой
считать: считать
птичка: птичек
давать: дал даст
заблуждение: заблуждение
поскольку: поскольку
фпс: фпс
обязательный: обязательна
продолжать: продолжает
пополняться: пополнится
сравнение: сравнение
iphone: iphone
сайт: сайт сайте
ссылка: ссылка
посмотреть: посмотреть
мультимедиа: мультимедиа
становиться: стало стал
поддерживать: поддерживает
хакер: хакеров
openai: openai
редакция: редакции
российский: российского
довольствоваться: довольствуются
скорость: скорость
gpu: gpu
duty: duty
новость: новости
политика: политика
владелец: владельцам
блок: блоки
перевод: переводы
doom: doom
покупка: покупке
автономный: автономные
техника: техника
против: против
вернуть: вернет
уборка: уборки
требование: требований
edge: edge
тренд: тренде
питание: питания
прогноз: прогнозы
смартфон: смартфоны смартфонов
узвямиость: узвямиости
geforce: geforce
разгон: разгон
вопрос: вопросы вопрос
ворд: ворде
аккумулятор: аккумулятор
возникать: возникает
робот: роботами
вместе: вместе
безопасно: безопасно
сетевой: сетевые сетевое
назначение: назначения
google: google
ii: ii
resurrected: resurrected
использовать: использовать
слышать: слышал
возможно: возможно
научаться: научится
чат: чат
все: всему
устаревать: устаревших
разработчик: разработчики
управлять: управлять
расти: растут
прирост: прирост
команда: команда
актив: активов
задавать: задать
chatgpt: chatgpt
писать: писать
первый: первый
периферия: периферия периферии
достаточно: достаточно
trashexpert: trashexpert
находиться: находятся
фото: фото
слово: слово
электронный: электронные
красота: красота
модель: моделях
козырь: козырь
показывать: показать
youtube: youtube
telegram: telegram
материнский: материнские
работать: работает
vk: vk
правообладатель: правообладателям
неисчезающий: неисчезающим
хранилище: хранилища
тб: тб
bird: birds
функция: функция
торговый: торговые
m: ms
apple: apple
экшн: экшн
трафик: трафика
проверка: проверки
устанавливать: установили
известно: известно
документ: документа
tor: tor
лазейка: лазейку
игровой: игровые
pinterest: pinterest
ранний: ранней
вводить: ввел
системный: системных
время: времени
обновление: обновление
статья: статьи
ещ: ещ
технический: технической
корпус: корпусов корпуса
call: call
vpn: vpn
cyberpunk: cyberpunk
спутник: спутника
убирать: убрать
конфиденциальность: конфиденциальности
лента: лента
установленный: установленные
день: дни
условие: условия
прототип: прототип
защищать: защищенной
io: ios
заяц: зайцы
результат: результаты
недостаток: недостатков
пк: пк
электроинструмент: электроинструменты
macos: macos
прощание: прощание
способ: способов
вина: виной
веб: веб
возвращение: возвращением
офисный: офисная
diablo: diablo
телеграмма: телеграмма
предварительный: предварительной
g: g
отличие: отличие
марка: марки
наушник: наушники
тест: тесты тестов
