menyaksikan: menyaksikan
kali: kali
daftar: daftar
khawatir: khawatir
datang: datang
saja: saja
togellers: togellers
tabel: tabel
menunggu: menunggu
khususnya: khususnya
draw: draw
pilihan: pilihan
cari: cari
meragukan: meragukan
melihat: melihat
situs: situs
bisa: bisa
dengan: dengan
informasi: informasi
penyajian: penyajian
login: login
dalam: dalam
sebuah: sebuah
keluar: keluar
bermodalkan: bermodalkan
pool: pools
saksikan: saksikan
dan: dan
reserved: reserved
mendapatkannya: mendapatkannya
siaran: siaran
terbagikan: terbagikan
bagaimana: bagaimana
pemilihan: pemilihan
ikuti: ikuti
masuk: masuk
pecinta: pecinta
terbesar: terbesar
membuat: membuat
selamat: selamat
induk: induk
terlengkap: terlengkap
tersaji: tersaji
terakurat: terakurat
mulai: mulai
serba: serba
penting: penting
nantinya: nantinya
para: para
seminggu: seminggu
whatsapp: whatsapp
jam: jam
lagi: lagi
tersebut: tersebut
terbagi: terbagi
sempat: sempat
wla: wla
jenis: jenis
tetapi: tetapi
legendaris: legendaris
wib: wib
atas: atas
ambil: ambil
luncurkan: luncurkan
minati: minati
menyajikan: menyajikan
tersimpan: tersimpan
baru: baru
sebab: sebab
bola: bola
khusus: khusus
tercepat: tercepat
menjadi: menjadi
hasil: hasil
terciptannya: terciptannya
prose: proses
terpilih: terpilih
menjadikannya: menjadikannya
prize: prize
terjamin: terjamin
bagi: bagi
fitur: fitur
mengandung: mengandung
bettro: bettro
utama: utama
berkala: berkala
semua: semua
kapan: kapan
atau: atau
data: data
caranya: caranya
agar: agar
canggih: canggih
rekapan: rekapan
saat: saat
oleh: oleh
angka: angka
hanya: hanya
jangan: jangan
sangat: sangat
mengakses: mengakses
live: live
indonesia: indonesia
kesusahan: kesusahan
result: result
hari: hari
toto: toto
melalui: melalui
pengeluaran: pengeluaran
sebagai: sebagai
tujuan: tujuan
bandar: bandar
di: di
melihatnya: melihatnya
seluruh: seluruh
terdapat: terdapat
pembagian: pembagian
adalah: adalah
selalu: selalu
perlu: perlu
sendiri: sendiri
paling: paling
langsung: langsung
mengapa: mengapa
jaman: jaman
maupun: maupun
ataupun: ataupun
jadwal: jadwal
secara: secara
merupakan: merupakan
tidak: tidak
dapatkan: dapatkan
pada: pada
anda: anda
ini: ini
right: rights
lima: lima
yang: yang
digital: digital
dari: dari
dapat: dapat
togel: togel
tersajikan: tersajikan
sajalah: sajalah
akan: akan
penentu: penentu
pihak: pihak
smartphone: smartphone
menyerbu: menyerbu
ingin: ingin
untuk: untuk
keluaran: keluaran
copyright: copyright
terciptakan: terciptakan
mau: mau
resmi: resmi
togelmania: togelmania
keasliannya: keasliannya
banyak: banyak
melewatkan: melewatkan
karena: karena
livechat: livechat
sudah: sudah
pemain: pemain
setia: setia
singapore: singapore
nomor: nomor
pasangkan: pasangkan
ialah: ialah
mengikuti: mengikuti
bettor: bettor
cara: cara
berupa: berupa
setiap: setiap
sgp: sgp
menyediakannya: menyediakannya
pun: pun
manapun: manapun
sehingga: sehingga
mana: mana
