new: new
продолжать: продолжая
цена: цена
функциональный: функциональные
объединять: объединяющие
сочетать: сочетающие
pc: pc
разновидность: разновидности
погрузчик: погрузчиков погрузчика погрузчики погрузчик
конструкция: конструкции конструкция
трактор: трактора
фронтальный: фронтального фронтальный фронтальных
файл: файлами
экскаватор: экскаваторов экскаватор
являться: является
внешний: внешний
шахтный: шахтные шахтного
один: одно
информация: информация
это: это
cookie: cookie
применение: применение применения
тонный: тонный
вид: вид виды
способный: способный
себя: собой
тсм: тсм
карта: карта
обустройство: обустройство
фото: фото
выпуск: выпуском
измельчитель: измельчитель
химический: химическое
хранение: хранения
универсальный: универсальные
сайт: сайт сайта
склад: склада
тали: тали
holland: holland
высококлассный: высококлассные
правило: правило
запись: записям
оборудование: оборудование оборудования
дробилка: дробилкам дробилка
область: область
видео: видео
серия: серия
выполнять: выполнять
дробление: дробления дробление
atlas: atlas
навигация: навигация
данный: данных
подразумевать: подразумевает
обязательный: обязательным
ремонт: ремонт
характеристика: характеристики
компания: компания
мировой: мировой
складской: складской
горный: горно
материал: материалов
новость: новости
заниматься: занимающуюся
итальянский: итальянского
политика: политика
седьмой: седьмая
техника: техника техники
промышленный: промышленного промышленной
paus: paus
обогатительный: обогатительное
согласие: согласие
грузоподъемность: грузоподъемности
обходиться: обходится
обзор: обзор
предприятие: предприятиях предприятие предприятия
строительный: строительная
copco: copco
рубрика: рубрики
ftb: ftb
число: числе
дро: дро
этот: этими
процесс: процессом
ok: ok
копко: копко
технический: техническая
задача: задачи
hermann: hermann
конусный: конусным
технологический: технологическим
различный: различной
организация: организации
особенность: особенности
добывать: добывающее
zx: zx
нормативный: нормативная
gmbh: gmbh
тегеха: тегех
атлас: атлас
производство: производстве производство
производитель: производители производителя производитель
содержание: содержанию
свое: свое
металлургический: металлургическое
двадцать: двадцати
относиться: относится
мелкий: мелкого
конфиденциальность: конфиденциальности
справочник: справочник
высокотехнологичный: высокотехнологичного
кмд: кмд
сельскохозяйственный: сельскохозяйственная
руда: руды
преимущество: преимущества
коммунальный: коммунальная
модель: модель модели
вилочный: вилочных
природный: природных
машина: машины
спецтехника: спецтехника
переходить: перейти
давать: даете
работа: работы работу
использовать: использовать использует
корпорация: корпорацию
многоцелевой: многоцелевой
лидер: лидер
тяжелый: тяжелый
maschinenfabrik: maschinenfabrik
прочий: прочая
функция: функцию
логистический: логистической
далее: далее
jcb: jcb
грузоподъемный: грузоподъемной
составлять: составляющая
лесозаготовительный: лесозаготовительная
terex: terex
грузовик: грузовики
принцип: принцип
специализированный: специализированной
немецкий: немецкая
search: search
зона: зоны
представлять: представляет
b: b
маневренный: маневренных
