свежий: свежие
россия: россии
текущий: текущих
охватывать: охватывающую
рф: рф
ваш: вашего
источник: источник
возможность: возможности возможностях
доменный: доменных доменные доменного доменной
подробно: подробнее
сервис: сервисов
появляться: появятся
сторона: стороны
российский: российского российских
получать: получаемые
сайт: сайта сайты сайте
обязательный: обязательна
предоставление: предоставление
раздел: разделе
сравнение: сравнение
аналитика: аналитика
группа: группу
главный: главная
su: su
работать: работают
цифра: цифр
ссылка: ссылка
создавать: создать
регион: регионе
скольким: скольких
первый: первых
x: x
интернет: интернета интернет
зарегистрировать: зарегистрировано
домен: доменов домены
какой: каком
законодательство: законодательством
технический: технического технический
поддержка: поддержка
javascript: javascript
мировой: мировой мировая
сообщение: сообщение
находиться: находящиеся
материал: материалов материалы
представлять: представлены представляет
отч: отч
проверять: проверьте
русский: русский
н: н
данные: данные
график: графиков
настройка: настройки
смочь: сможете
зона: зоны зонах
анализ: анализом
статистика: статистика статистику
основной: основных
демонстрация: демонстрацией
страница: страницах страницей
диаграмма: диаграмм
развитие: развития
любой: любом
статья: статьи
пожалуйста: пожалуйста
ежедневно: ежедневно
браузер: браузера
целое: целом
использование: использовании
самый: самые
соответствие: соответствии
требоваться: требуется
индустрия: индустрии
достоверный: достоверные
пользовательский: пользовательское
определение: определения
english: english
центр: центра центр
ru: ru
термин: термины
всеобъемлющий: всеобъемлющую
сколько: сколько
помимо: помимо
пространство: пространства
соглашение: соглашение
ооо: ооо
проект: проекте
ресурс: ресурс ресурса
полный: полную
публиковаться: публикуются
подробный: подробным
охраняться: охраняются
показатель: показателей
рука: рук
узнавать: узнать
новый: новые
право: права
готовый: готово
изменять: изменить
внимание: внимание
тренд: трендов
тов: тов
работа: работы
