вопрос: вопросов вопрос
россия: россии
органично: органично
продолжать: продолжая
пожертвование: пожертвование
поддерживать: поддержать
болеть: болеет
использование: использования
рак: рак рака
рождение: рождения
корректно: корректно
клиника: клиниках
это: это этому
вариант: вариант
подарить: подари
немедицинский: немедицинская
волонтерство: волонтерство
волонтер: волонтера волонтером
браузер: браузеров браузер
cookie: cookie
ребенок: ребенка детям детей дети ребенок
формат: формат
день: день
chrome: chrome
подробно: подробно
лечиться: лечится
вискотт: вискотта
раздел: разделе
пожертвовать: пожертвовать
рассказывать: рассказывает
лимфобластный: лимфобластный
прежний: прежнему
помогать: помогают помогает помочь помогать
сайт: сайт
правило: правилами
проект: проекты проекта проекту
eu: eu
чаепитие: чаепитие
например: например
работать: работаем
собирать: соберите
главное: главное
волонтерский: волонтерских
благотворительный: благотворительный благотворительную
соцсеть: соцсетях
реабилитация: реабилитация
который: которое которым
событие: событие
контакт: контакты
фонд: фонду фонде фонд фонда
podari: podari
отображать: отображать
пользоваться: пользуйтесь
адресный: адресная
подъемный: подъемно
life: life
необходимый: необходимое
становиться: стать станьте
делать: делаем делать
поддержка: поддержка
дима: дима
детский: детский
скачать: скачать
поделиться: поделиться
семья: семью
друг: друзья друзьями другом
делаться: делается
принцип: принципах
превращать: превратить
расследование: расследование
концерт: концерт
решать: решить
очень: очень
позволять: позволяет
согласие: согласие
публикация: публикации
выбирать: выбрать выберите
лечение: лечение
файл: файлов
разный: разных
корпоративный: корпоративной
letidor: letidor
ситуация: ситуация
социальный: социальная
заниматься: занимается
словом: словом
оставаться: оставалось
сша: сша
кровь: кровь
основываться: основывается
устаревать: устарел
android: android
издание: издании
небольшой: небольшое
любой: любое любой
получать: получить
класс: класс
сожаление: сожалению
мастер: мастер
firefox: firefox
удобный: удобный
акция: акцию
увы: увы
жизнь: жизнь
giftoflife: giftoflife
пожалуйста: пожалуйста
софия: софия
великобритания: великобритании
системный: системная
тема: тему
сдавать: сдать
прямо: прямо
донорство: донорство
соглашаться: соглашаетесь
цифра: цифрами
какой: каких
важный: важному
помощь: помощи помощь
обработка: обработку
лейкоз: лейкоз
наш: наш
покупать: покупая
рачковый: рачкова
история: истории
возникать: возникает
приложение: приложение
экологичный: экологично
олдрич: олдрича
власова: власова
google: google
выходить: вышло
переводить: переводят
платформа: платформа
ваш: ваша
жить: жить
современный: современных
давать: даете
io: ios
почему: почему
подписываться: подписывайтесь
использовать: использовать
нуждаться: нуждается
выгорание: выгорания
меню: меню
острый: острый
амбулаторный: амбулаторное амбулаторные
возможно: возможно
en: en
деньги: деньги
способ: способов
каждый: каждого
длиться: длится
кожуховский: кожуховский
бонус: бонусами
safari: safari
gift: gift
родитель: родителей
долго: долго
устанавливать: установите
нужный: нужна
квартира: квартиры
рок: рок
руководитель: руководитель
программа: программ
синдром: синдром
елена: елена
держаться: держитесь
измалково: измалково
партнерский: партнерский
пансионат: пансионат
мочь: мог
психология: психология
