книга: книга
дополняться: дополняться
биография: биография биографию
почитать: почитать
галерея: галереи галерея
жизнь: жизни
ru: ru
игорь: игорь игоря
художник: художник художника художнике
лягин: лягин
страница: страницах
изучать: изучить
краткий: краткую
развиваться: развиваться
back: back
сми: сми
статья: статьи
работа: работами работ
творчество: творчестве творчество
систематизация: систематизацией
понравиться: понравится
семья: семья
начало: начало
сайт: сайта сайт сайте
лягина: лягина
гостевой: гостевая
en: en
видеть: видеть
мы: нам
уважение: уважением
представлять: представлены
соц: соц
заглядывать: загляните
надеяться: надеемся
top: top
c: c
фотография: фотографии
николаевич: николаевича
информация: информации
очень: очень
периодически: периодически
далеко: далеко
публикация: публикации
мочь: можете
личный: личные
поэтому: поэтому
графика: графика
различный: различных
постоянно: постоянно
замечательный: замечательного
познакомиться: познакомиться
работать: работаем
сеть: сети
авторский: авторскими
живопись: живопись
посмотреть: посмотреть
рад: рады
период: периодов
картина: картины
контакт: контакты
непременно: непременно
