шов: шва
подробно: подробнее
space: space
монтажный: монтажные монтажный
free: free
компания: компании компания
менеджер: менеджер менеджера
дом: дом
лицо: лиц
именно: именно
декабрь: декабря
loox: loox
аксессуар: аксессуары
дверной: дверная дверные
заказ: заказе заказов
свобода: свободы
группа: группу
количество: количество
трендсеттер: трендсеттером
настенный: настенные
газлифт: газлифты
ответ: ответ
гладильный: гладильные
наш: наши
решение: решения
ценовой: ценовая
юридический: юридических
мебельщик: мебельщиков
заказывать: закажи заказывали заказать
один: одним одном
реквизит: реквизиты
корзина: корзины корзина
отгрузка: отгрузка
хороший: лучшие хороша
технический: техническим
стойка: стойка
ванный: ванных
замок: замки замков
писать: пишут
мебельный: мебельной мебельную мебельные мебельная
раздвижной: раздвижные раздвижных
очень: очень
личный: личный
освещение: освещение освещения
бесшумный: бесшумный
функциональность: функциональность
заменять: заменили заменить
ноунейм: ноунейм
пример: примеру
цокольный: цокольный
материал: материалы
доска: доски
выдвижной: выдвижных выдвижные
выходить: вышел
уговаривать: уговорил
простой: просты простых
навес: навесы
info: info
каталог: каталог каталоги
трансформация: трансформации
интернет: интернет
блюм: блюм
дело: дела дело
стекло: стекла
искать: искали
давать: дала
угловой: угловые
представление: представление
известный: известных
мир: мира
ул: ул
полностью: полностью
мник: мник
конечный: конечного
архитектурный: архитектурной
шеф: шеф
бренд: брендов бренды бренд
весь: всей
коллекция: коллекции коллекция
закрывание: закрывания
китайский: китайский китайских
поставлять: поставили поставляем
максификс: максификс
древесина: древесины
ваш: ваш
dialock: dialock
телевизор: телевизоров
личинка: личинки
делать: делаем делали
россия: россии
sale: sales
производство: производству
добро: добро
соединительный: соединительная
строй: строя
matrix: matrix
уплотнитель: уплотнители
кабинет: кабинет
сдвижной: сдвижные
ноябрь: ноября
быстро: быстро
причина: причинам
box: box
наполнение: наполнение
страна: стран
обувь: обуви
попросить: попросила
мебель: мебели мебель
перегородка: перегородок
hafele: hafele
hafeleshop: hafeleshop
обработка: обработка
ящик: ящики ящиков ящике
bыдвижные: bыдвижные
система: системы
отзыв: отзыв отзывы
предложение: предложения
вдохновитель: вдохновителем
применение: применения
артикул: артикулов
ткин: ткина
фурнитура: фурнитуру фурнитура фурнитуры
кухня: кухню кухне кухня кухни
случай: случае
товар: товаров товар
строительный: строительной
увеличивать: увеличьте
шина: шины
г: г
мировой: мировой
телефон: телефоны
потребитель: потребителя
купить: купили купить
домой: домой
slido: slido
доставка: доставкой доставка доставке
автоматический: автоматические
стяжка: стяжка стяжек
производитель: производителям производителей производитель
рекомендовать: рекомендую
кровать: кроватей
поэтому: поэтому
уникальный: уникальные
официальный: официальном
клиент: клиенты
vitalinka: vitalinka
надежный: надежный
уважаемый: уважаемые
кухонный: кухонные кухонный
оставлять: оставить
прайс: прайс
бутылочница: бутылочницы
h: h
сейф: сейфы
светодиодный: светодиодных светодиодное
стоимость: стоимость
дизайнер: дизайнерам
доводчик: доводчики
русый: рус
пользоваться: пользуемся
индивидуальный: индивидуальному
вс: вс
ручка: ручки
гибкий: гибкая
доступ: доступа
порог: пороги
рейлинг: рейлинги
существовать: существует
вместо: вместо
переходить: перейти
идея: идей
ru: ru
дверь: двери дверей
нажатие: нажатия
тысяча: тысяч
новый: новую
распродажа: распродажа
посудосушитель: посудосушители
идеальный: идеальное
назад: назад
подъемный: подъемные
фасад: фасадов фасаде
муж: муж
обращаться: обратиться
оферта: оферта
изменять: изменить
профильный: профильные
множество: множеством
возобновление: возобновления
высоко: выше
цена: цена
совет: совету
кронштейн: кронштейны
плавный: плавные плавного
hawa: hawa
получаться: получилась
это: это
гардероб: гардеробов
под: подъ
продукция: продукцией
данна: данной
подбор: подбора
город: город
сравнение: сравнение
складной: складных
замена: замену
плотный: плотное
год: года
колонна: колонны
решать: решил
справка: справка
производить: производим
рама: раме
особенный: особенный
открывание: открывания
промышленность: промышленности
контактный: контактная
кв: кв
оплата: оплата
думать: думаю думал
мы: нам
новость: новости
политика: политика
повар: повар
немецкий: немецкое немецкую немецкие
реставрационный: реставрационные
встраивать: встраиваемые
петля: петли
ассортимент: ассортимент
этот: эта
вконтакте: вконтакте
гарнитур: гарнитур
лист: лист
лицевой: лицевая
светильник: светильников светильник
подъемные: подъемных
механизм: механизмов механизмы
контроль: контроля
доставлять: доставляем
направляющий: направляющие
вопрос: вопрос
курьерский: курьерской
cистема: cистема
подробность: подробности
установка: установке
откладывать: отложенные
многий: многих
напрямую: напрямую
иметь: имея имею
инструмент: инструмент
получать: получи
происходить: происходит
сумма: сумму
магазин: магазин магазине
индустрия: индустрия
долго: долго
качественный: качественную
разный: разное
разрабатывать: разрабатываем
поворотный: поворотная
возможность: возможности
ехать: еду
профиль: профиль
работа: работы
видно: видно
задавать: задать
метр: метра
обеспечивать: обеспечивает
подтягивать: подтягивать
публичный: публичная
являться: является
акция: акции
разбираться: разобрался
открывать: открыла
информация: информация
посоветовать: посоветовал
устанавливать: установить
плюс: плюс
минибара: минибары
август: августа
направление: направлений
сопротивляться: сопротивлялся
контакт: контакты
огромный: огромное
youtube: youtube
дизайн: дизайн
стягивание: стягивание
влиять: влияют
предлагать: предложили
обмен: обмен
возврат: возврат
защелка: защелки
рубль: рублей
комната: комнат
широкий: широкий
рассылка: рассылку
дешевый: дешевое
сервис: сервисы
именитый: именитых
конфигуратор: конфигуратор
статья: статьи
бесплатный: бесплатная
октябрь: октября
подписываться: подписаться
классический: классическая
конфиденциальность: конфиденциальности
двойной: двойные
сентябрь: сентября
находить: найти
еврозапил: еврозапилом
условие: условия
новинка: новинки
входить: войти
цилиндр: цилиндры
звонок: звонок
возможный: возможное
задержка: задержкой
качество: качество
лидер: лидер
стол: столов
москва: москва
fele: fele
landned: landned
проект: проекту проекты
довольный: доволен
p: p
хефела: хефеле
стабильный: стабильной
