datsun: datsun
стол: стол
пересечение: пересечения
автоновинка: автоновинки
электрокара: электрокары
глубокий: глубокий
появляться: появились появится
долгий: долгий
орган: органы
захватить: захватить
евгений: евгений
oофициально: oофициально
компания: компании компания
который: которое которые который которая
российский: российские российским российских
испанский: испанские испанских
создавать: создадут создана создавать
именно: именно
иметь: имеет
аксессуар: аксессуары
современный: современных современным
белоруссия: белоруссия белоруссии
hyundai: hyundai
количество: количество
общий: общего
кроссовер: кроссоверы кроссовера кроссовер
выходить: выйдет
нынешний: нынешнего
видео: видео
об: объ
гарантия: гарантией
раскрывать: раскрыла раскрыли
компонент: компонентов
mitsubishi: mitsubishi
т: т
обсуждение: обсуждение
быть: будьте
центр: центрах
электромобиль: электромобилей электромобили
срок: срок
весна: весны
маневренность: маневренность
павел: павел
многие: многие
президент: президент
продажа: продажа продаж
хотеть: хочу хотят
новое: новое нового
определенный: определенных
драйв: драйв драйвы драйва драйвов
сотрудник: сотрудников
очень: очень
частность: частности
motorpage: motorpage
subaru: subaru
обновлять: обновленной
профсоюз: профсоюзов профсоюзами
cx: cx
вездеход: вездеходы
сегодняшний: сегодняшнего
импортировать: импортированы
creta: creta
называть: названа
привод: привод
mercedes: mercedes
урок: уроки
целиком: целиком
партия: партии
максимально: максимально
ferrari: ferrari
дилерский: дилерских
завершение: завершении
взглядывать: взгляните
сконцентрироваться: сконцентрируется
коммерческий: коммерческие
tucson: tucson
допустимый: допустимые
миллион: миллионов
генерировать: генерировать
lifan: lifan
escalade: escalade
каталог: каталог каталоге
черя: чери
подробность: подробностей
покупка: покупку покупке
ford: ford
россия: россией россии россию
выделяться: выделился
лада: лада
eqe: eqe
exeed: exeed
процедура: процедур
jaguar: jaguar
lada: lada
кровь: кровей
производство: производства производству производство
липовицкий: липовицкий
соглашение: соглашения
римац: римацом
собирать: собраны
дата: дату дата
jeep: jeep
конвейер: конвейер конвейере
речь: речь
наш: наш нашем
водитель: водители водителей
фирменный: фирменного
слух: слухи
поступать: поступало
автодор: автодоре
никоноров: никоноров
выступление: выступление
тариф: тарифов
популярный: популярные
ингольштадтский: ингольштадтский
e: es
подписывать: подписал
автопром: автопроме
объявлять: объявила
автозавод: автозаводам
успокаивать: успокоить
лифтбэк: лифтбэком
илья: илья
оммаж: оммаж
honda: honda
сообщать: сообщила сообщают
автодилер: автодилеры
двигатель: двигателя
прохождение: прохождения
приставка: приставкой
автохимия: автохимия
bmw: bmw
разрабатывать: разрабатывать
вернуться: вернулись
простой: простой
citroen: citroen
ижевск: ижевск
площадка: площадка
мало: мало
молодость: молодость
построить: построит
электрический: электрических
погранпункт: погранпунктах
восторг: восторг
взлетать: взлетят
выступать: выступил выступила
ходить: ходили
официальный: официальной официальных официальным
брат: брата
аналитика: аналитика
оказываться: оказалась оказалось
забеспокоиться: забеспокоились
увольнение: увольнении
хорват: хорватом
проезд: проезд проезда
марка: марок марки марка
такой: такого
мировой: мировом
поколение: поколение
авангард: авангард
версия: версии
платный: платным
отзыв: отзывы
массовый: массовые
ехать: едет
другой: другая
бронирование: бронировании
устройство: устройства устройство
больший: большая
пятилетний: пятилетняя
принимать: приняло принято
сми: сми
машина: машины машин машинах
юбилей: юбилею
шина: шины
говорить: говорят
автомобиль: автомобили автомобилей автомобиля
royce: royce
снегоход: снегоходы
курс: курсе
начинать: начинают
тест: тест тесты
разумеется: разумеется
chevrolet: chevrolet
land: land
заниматься: занимается
кто: кому
значение: значения
ратификация: ратификации
свой: своих своего свои
выпускаться: выпускались
greyp: greyp
восстановление: восстановлению
juke: juke
изменяться: изменится
полезный: полезное
главный: главного главный
volkswagen: volkswagen
опубликовывать: опубликовала
стоимость: стоимость
превращать: превратит
jetour: jetour
блогер: блогер
русый: рус
михаил: михаил
заявление: заявлений заявлением
вс: вс
план: планы
нужный: нужен
информация: информации
дорога: дорогам
рынок: рынке рынок
шмаков: шмаков
прочитывать: прочитать
правда: правда
старший: старшего
научать: научили
появление: появлением появлении
автопроизводитель: автопроизводители
fiat: fiat
похоже: похоже
nissan: nissan
семейство: семейства
нной: нное
ru: ru
повезти: повез
меню: меню
iran: iran
ао: ао
иранский: иранских иранского
история: история
цена: цены
закрывать: закрыть
выпуск: выпуске выпуском
скорый: скором
мат: мате
вышеуказанный: вышеуказанном
фон: фоне
субсидировать: субсидировать
правительство: правительства правительство
мир: мире
вторичный: вторичный
процесс: процесс
тольятти: тольятти
посвящий: посвящ
автошкола: автошкола
запускать: запущен
трасса: трассам
сделать: сделали сделала
тесто: тесте
n: n
tesla: tesla
утвердить: утвердило
граница: границе границы
суперкаров: суперкаров
потратить: потратить
считать: считать
велосипед: велосипедов
mazda: mazda
индустрия: индустрию
простаивать: простаивать
рука: руках
бренд: бренда
лаздин: лаздин
фотография: фотографии
данна: данной
корея: кореи
автомобильный: автомобильной автомобильных автомобильном
заранее: заранее
обходить: обошел
полный: полный
проект: проекта
год: года
car: car
законопроект: законопроект
понимать: понимать поняли
мультимедиа: мультимедиа
выход: выхода
возобновление: возобновление
ретро: ретро
автоэнциклопедия: автоэнциклопедия
сравнительный: сравнительные
пдд: пдд
отечественный: отечественном
вспомнить: вспомнила
купля: купля
jolion: jolion
расход: расходов
мы: нам
сертификация: сертификацию сертификация
знать: знаем
доступный: доступнее
новость: новостей новости
необходимый: необходимых
старт: старте старта
motor: motors
китайский: китайского
середина: середине
saipa: saipa
miura: miura
toyota: toyota
летний: летнему
сказать: сказать
статистика: статистика
авторынок: авторынке
продолжать: продолжают
trail: trail
официально: официально
выставка: выставки
подержать: подержанных
сила: силу
roll: rolls
китай: китая
ng: ng
становиться: станут
volvo: volvo
давно: давно
cadillac: cadillac
сборка: сборку
владимир: владимир
крупный: крупный
c: c
признавать: признает
помощь: помощи
vx: vx
росатый: росатом
porsche: porsche
lamborghini: lamborghini
байков: байков
сокращение: сокращения
модель: модель модели моделей
электрокар: электрокаров
признание: признанию
место: места мест
сегмент: сегмент
интервью: интервью
time: time
подписываться: подписывайтесь
путин: путин
seat: seat
противоугонный: противоугонные
новинка: новинка новинки
часть: часть
audi: audi
lexus: lexus
вступать: вступает
обязывать: обязывающий
geely: geely
завод: завод
казаться: казалось
rimac: rimac
анатолий: анатолий
мотоцикл: мотоциклы
новый: новые
экземпляр: экземпляры
актуальный: актуальных
мом: мом
сам: самих
автопутешествие: автопутешествия
действовать: действуют
new: new
начинаться: началась
infiniti: infiniti
британский: британские
bai: bai
интересный: интересный
эксперт: эксперты
менталитет: менталитет
актив: актива
достаточно: достаточно
сайт: сайте
стоять: стоят
пока: пока
отправляться: отправится
правильно: правильно
зиничев: зиничев
необычный: необычным
редактор: редактора редактор
недавний: недавнего
renault: renault
участие: участием
предложение: предложением
круглый: круглый
электровелосипед: электровелосипедов
попытка: попыток
vesta: vesta
проводить: проводят
rover: rover
открывать: открыть
x: x
прочее: прочее
нарушение: нарушения
suzuki: suzuki
взаимный: взаимному
ограничение: ограничения
ning: ning
квадроцикл: квадроциклы
собственный: собственную
создание: создания создании
небо: небес
great: great
неопытность: неопытность
инфраструктура: инфраструктуру
w: w
закон: закон
line: line
калиниград: калиниграде
день: дня
тюнинг: тюнинг
рубль: рублей
диск: диски
е: е
поспешить: поспешили
литр: литра
сертификационный: сертификационные
слово: слову
opel: opel
постепенно: постепенно
отрасль: отрасли
bentley: bentley
авто: авто
февраль: февраля
привозить: привезли
перемена: перемена
лосиный: лосином
инсайдер: инсайдеры
kia: kia
tank: tank
однако: однако
smart: smart
время: времени
leon: leon
идти: идет
представитель: представителей представители
generation: generation
характеристика: характеристиками
khodro: khodro
мнение: мнение
культовый: культовой
оценивать: оценивать
происходить: произошло произошли
skoda: skoda
wall: wall
беби: беби
необходимо: необходимо
обзор: обзоров
заряжать: заряженный
основатель: основателем
benz: benz
genesis: genesis
перенести: перенесли
пять: пять
аккумулятор: аккумуляторов
отказываться: отказывается
штраф: штрафы
бронировать: бронировать
peugeot: peugeot
автоновость: автоновости
запчасть: запчастей
осень: осенью
предприятие: предприятии
ssangyong: ssangyong
qashqai: qashqai
комплектующий: комплектующие
обычный: обычным
направлять: направлены
haval: haval
основной: основной
ravon: ravon
калиц: калицев
премиальный: премиального
блог: блог
наказание: наказаний
