повестись: повелось
коммуникация: коммуникации коммуникаций
runner: runner
подешеветь: подешевела
угроза: угрозой
denso: denso
вьетнам: вьетнама
наступать: наступивший
такой: таких таком такого такие
автомобиль: автомобилей автомобиль
сириус: сириус
выпуск: выпуск выпуском выпуска
начало: начало
долго: долго дольше
hyundai: hyundai
отсутствие: отсутствие
далеко: дальше
огромный: огромным огромного
настольный: настольных
серия: серию серия серии
titan: titan
интерес: интересах интерес
быстрый: быстрой быстрый
возможность: возможностью
тень: тени
метавселенная: метавселенной
самый: самый самым самое самая самом самых самые
менее: менее
продажа: продажу продажам продажи продаж продаже
перемена: перемены
молодость: молодости
xt: xt
очень: очень
реклама: реклама
публикация: публикации
охрана: охране
потерять: потерять потеряно
рецензия: рецензии рецензия
изображение: изображений
смартфон: смартфонов смартфонами смартфон смартфона смартфоны
удаваться: удалось
liqtech: liqtech
стратегический: стратегическую
проходить: пройти
пример: примеру
лихой: лихим
предзаказ: предзаказы
главный: главными главные главной главный
безопасность: безопасности безопасность
останавливать: остановил
задача: задач
аравия: аравии
принимать: принимают
система: системами систем система системы
комплектующий: комплектующих
процессор: процессорам процессоров процессоры процессора процессоре
магазин: магазинов
налаживать: наладить
спрогнозировать: спрогнозировали
игрок: игрокам игроки игроков
мобильный: мобильный мобильная
микроскопический: микроскопических
способствовать: способствует
платформа: платформы платформе
gt: gt
цитирование: цитировании
лишенный: лишен
серьезный: серьезными
штурм: штурм
сегодня: сегодня
стираться: стирается
высота: высот
намереваться: намеревается
смочь: смогла сможет
amd: amd
помимо: помимо
речь: речи речь
начн: начн
антураж: антуражем антураж
луна: луны
наш: нашем наша нашей наш наши
скидка: скидки скидка
vr: vr
half: half
стабилизироваться: стабилизировалась
ловушка: ловушке
китайский: китайское китайского китайский китайской китайские китайским китайских
жные: жные
model: model
семь: семь
вещь: вещи
mpg: mpg
zotac: zotac
запрет: запрет
ггц: ггц
gamesblender: gamesblender
свой: своем своими своей свои своих своего
втихомолку: втихомолку
aorus: aorus
elsa: elsa
k: k
марсоход: марсоход марсохода
fountain: fountain
топ: топах топ
россия: россии
двухмерный: двухмерных
оценка: оценку
включая: включая
состояние: состояние
обсуждать: обсуждаемые
tr: tr
проблема: проблем проблемы
watch: watch
читер: читеров
отрасль: отраслях
gtn: gtn
важный: важных важный
питаться: питающийся
ибп: ибп
подкупать: подкупает
флагман: флагманом флагманы
выходить: выйти выходят выходи
мастерская: мастерская
новый: новый новую новая новых новые
следующий: следующей
аналитика: аналитика
монитор: мониторы
дыра: дырах
издание: издание
чип: чип чипов чипы
трудность: трудности
мировой: мировых мировом
мода: моде
возвращение: возвращение
часы: часы
западный: западных
один: одной
анонсировать: анонсировала
rush: rush
life: life
контент: контент контента
данный: данных
steam: steam
горизонт: горизонте
давний: давняя
другой: другие другими другим других
эстетический: эстетическое
гарри: гарри
автономность: автономностью
создатель: создателей создатели
day: day
борьба: борьбу
перспективный: перспективные
служба: службой
гкость: гкость
купить: купить
фанат: фанаты фанатов
инженер: инженеры инженерам
производство: производства производство
познакомиться: познакомились
state: state
электроника: электроники электроника
млн: млн
иллюстрация: иллюстраций
выпускаться: выпускаются
восприниматься: воспринимался
электронный: электронное
отрыть: отрытый
edition: edition
ранний: раннем
конец: конец конца
долгострой: долгострой
увольнение: увольнения
здравствовать: здравствуй
показывать: показали показал покажут показать
успех: успехи успехов
вт: вт
вс: вс
какой: какими каких какие
пора: пора
рынок: рынке рынка рынок
ssd: ssd
avr: avr
госпошлина: госпошлин
также: также
семейство: семейства
пиксел: пиксели
шесть: шесть
ring: ring
российский: российского российской российских российские
исключение: исключением
nintendo: nintendo
вместо: вместо
звезда: звезды
рекомендательный: рекомендательного
ч: ч
запуск: запуска запуск
противостояние: противостоянии
тысяча: тысяч тысячи
сердце: сердца сердце
цена: цены ценой цена
microsoft: microsoft
ryzen: ryzen
назад: назад
подряд: подряд
январь: января январе
двигаться: движется двигался
особенно: особенно
оптимизация: оптимизацию оптимизация
lg: lg
процесс: процесс
soft: soft
редкоземельный: редкоземельные
vivo: vivo
геймер: геймеров геймерам
этап: этапы
больший: большее большая
холод: холода
находить: нашли
пара: пару
это: это этим этому
игра: игру игр игра игрой игры
получаться: получилась
рнутый: рнутый
baidu: baidu
обязательный: обязательна
продолжать: продолжает продолжают
servernews: servernews
утечка: утечку
motorfest: motorfest
подтверждение: подтверждением
например: например
поддерживать: поддерживает поддерживать
предра: предр
приготавливаться: приготовьтесь
сан: сан
персональный: персональные
bch: bch
редакция: редакции
составной: составных составным
впечатлять: впечатляющей
мы: нам
солнечный: солнечной солнечному
отправлять: отправит
презентация: презентация
fromsoftware: fromsoftware
неоплата: неоплату
wolverine: wolverine
intel: intel
умный: умные умных
завязывать: завязать
покупка: покупке
переводить: переводить
актуальный: актуальные актуальны
размещать: размещая размещены
tn: tn
поддержка: поддержку поддержкой
власть: власти
плохо: плохо
формула: формулу
eo: eo
ма: ма
evil: evil
go: go
два: двумя две
робот: роботами
выделяться: выделиться выделяющийся
модель: модель модели моделями
регистрация: регистрации регистрация
использовать: использовать
legacy: legacy
мегафон: мегафон
развитие: развития развитие развитию
доля: доля доли
причем: причем
курсы: курсы
безбашенный: безбашенный
сделать: сделанных
просиживать: просидел
управлять: управлять
mar: mars
доезжать: доехали
выбирать: выбрать
акция: акций
консоль: консоль
экран: экраном экрана экраны
chatgpt: chatgpt
подводный: подводными
доставлять: доставляет
колонка: колонок
выглядеть: выглядит
команда: команд команды
сайт: сайт сайте
микросхема: микросхем
lord: lords
несмотря: несмотря
разномастный: разномастных
шестисотый: шестисотые
посмотреть: посмотрим
потребоваться: потребовался
серверный: серверную серверных
heart: heart
бандит: бандитами
контакт: контакты
forspoken: forspoken
сбегать: сбежал
материнский: материнской материнские
работать: работает работать
эффективный: эффективная эффективна
славный: славные
наращивание: наращиванием
буря: бури
компания: компании компания
чжуцюэ: чжуцюэ
частота: частотой
день: дня
задумываться: задумываются
выкуп: выкупу
рубль: рублей
рано: раньше
догадываться: догадаться
прошлое: прошлом прошлого
совершать: совершай
постепенно: постепенно
снижать: снизила
проект: проекты проект
хороший: лучших лучшие хорошую
дезинформация: дезинформации
востребовать: востребованным востребованные
рекламировать: рекламировать
avenger: avengers
позиция: позиции позиций
орбитальный: орбитальной орбитальным
месяц: месяца месяцами
хотя: хотя
ещ: ещ
компактный: компактного компактный
вид: виде
массовый: массовые массовых массовая
доступ: доступе доступ доступа
измерение: измерения измерение
свидетельство: свидетельство
создавать: создан создавать создали
интерфейс: интерфейсов
носить: носимая
lux: lux
польза: пользе
подавать: подали
небо: небе
namco: namco
китай: китай китаем китая китае
правило: правил
кабель: кабелями
впечатляющий: впечатляюще
встречаться: встречаются
почему: почему
трехмерный: трехмерным
вряд: вряд
задерживать: задержала
деталь: детали
расширение: расширению
снег: снег
дальнейший: дальнейшем
обычный: обычным
дньюс: дньюс
риск: рисках
поисковик: поисковик
corbos: corbos
instagram: instagram
g: g
причина: причин
вселенная: вселенной
строка: строку
взгляд: взгляд
среди: среди
flipper: flipper
свежий: свежие свежий
диск: диску
рост: рост
e: e
снова: снова
eth: eth
царь: царь
появляться: появились появятся появилась появилось
конкурент: конкурентов конкурентами
xtx: xtx
ядро: ядер
аппарат: аппараты
зав: зав
любопытный: любопытный любопытные
график: графики
chrome: chrome
рассылка: рассылка рассылок
крупный: крупную крупным
форум: форум
количество: количество количества количеству
zero: zero
dnews: dnews
оригинальный: оригинальной
гбайт: гбайт
первый: первое первые первой
бой: бой
видео: видео
развивать: развивает
sx: sx
обсуждение: обсуждение
указание: указанием
fallout: fallout
limited: limited
экшен: экшеном экшен
переосмыслять: переосмыслить
ноутбук: ноутбук ноутбуки ноутбука
предтоповой: предтоповая
mwc: mwc
мощный: мощные мощный
aio: aio
долгожданный: долгожданный
child: children
становиться: становится стать стала станет
настройка: настройки
потенциально: потенциально
ожидать: ожидали ожидаемая ожидаемые
тайвань: тайваня
unbound: unbound
отмена: отмена
давление: давление
перестрелка: перестрелки
нарушение: нарушением
благодаря: благодаря
future: future
сборка: сборке сборку
бесперебойник: бесперебойник
разработка: разработку разработке
быстродействие: быстродействия
обзор: обзоры обзор обзорах
моноблок: моноблок
собираться: собирается
заниматься: занимался
статус: статус
словенский: словенской
портал: портал
год: году лет года год годом
мир: мире миру мира мир
тгц: тгц
подборка: подборка
слишком: слишком
snapdragon: snapdragon
охлаждение: охлаждения охлаждение
весь: всей
молекула: молекулы
spellforce: spellforce
согласие: согласия
поехать: поехали
solar: solar
характеристика: характеристик
помощь: помощью
удовольствие: удовольствие
рекомендовать: рекомендовать
еженедельный: еженедельном
ремейк: ремейк ремейка
вредный: вредного
помощник: помощники
бот: бота
поездка: поездки
скатиться: скатится
аннулировать: аннулируют
фирма: фирмой
sony: sony
тыс: тыс
гранд: гранда
обещать: обещал
усиливаться: усиливаться
просто: просто
установка: установки
минимум: минимум минимума
версия: версии версию
запоминаться: запомнятся
marvel: marvel
строго: строго
популярный: популярных
энтузиазм: энтузиазмом
сми: сми
диапазон: диапазоном
патент: патенты патентов
смутный: смутные
fidelity: fidelity
тбайт: тбайт
valkyrie: valkyrie
спутник: спутников
pixel: pixel
культурный: культурного
средство: средств
keenetic: keenetic
потенциальный: потенциальный
ai: ai
play: play
hiper: hiper
h: h
роскосмос: роскосмос
класс: класса классе
inquisition: inquisition
стабильно: стабильно
лимит: лимиты
мочь: могут
ядерный: ядерные
z: z
зум: зум
интересный: интересных
наиболее: наиболее
покорять: покорять покорить
научать: научили
resident: resident
международный: международного
капсула: капсуле
within: within
elektrobit: elektrobit
первоклассный: первоклассная
spacex: spacex
canonical: canonical
геймпли: геймплей
история: историй история
фармацевтика: фармацевтику
видеокарта: видеокарт видеокарты видеокарту
третий: третье третью
снг: снг
финансовый: финансово
sapphire: sapphire
который: которые который которая
накопитель: накопители накопителя
энергия: энергию энергии
многообещающий: многообещающая
ннай: нная
кибербезопасность: кибербезопасности
blizzard: blizzard
сложно: сложно сложнее
посвящий: посвящ
rx: rx
zhaoxin: zhaoxin
среднее: среднем
сервис: сервисы сервисов
неудача: неудачу
билл: билл
погоня: погоне
глава: глава
mmo: mmo
ek: ek
сеть: сети
главное: главное
печение: печенья
дебаты: дебаты
рассказывать: рассказываем
вызывать: вызывать вызвало
кажется: кажется
захватить: захватит
usd: usd
whatsapp: whatsapp
изящный: изящный
лэптоп: лэптопа
выразительный: выразительного
обрушиваться: обрушившийся
авторизация: авторизация
mundfish: mundfish
трудный: трудный
событие: событиям событий события
tiktok: tiktok
помогать: помогло
манипуляция: манипуляциях
fallen: fallen
тренд: тренды тренде
обвинять: обвинили
намекать: намекают
бренд: брендом брендов
мошенничество: мошенничестве
цифровой: цифровые цифровой
оперативный: оперативной
виновный: виновным
шутер: шутера шутерах
внедрение: внедрением
душевный: душевная
немного: немного
аккумулятор: аккумулятор
личный: личную личный
подробность: подробности
google: google
обо: обо
вакансия: вакансии
совершенствовать: совершенствовать
наука: науки
lte: lte
суд: суды суд судов
лидировать: лидирующих
возможно: возможно
часть: частью часть
начальный: начального
toshiba: toshiba
флагманский: флагманский
распространять: распространила
открывать: откроют
акустика: акустика
совершенно: совершенно
uhs: uhs
начинаться: началась
получать: получит получили
любить: любимой
являться: является
маск: маск
перевед: перевед
место: места месте
мощность: мощности
нечисть: нечисть
быстро: быстрее
рискованный: рискованным
пугать: пугает
легкое: легких
ухабистый: ухабистое
дополнительный: дополнительный
модуль: модулем
ubisoft: ubisoft
нынче: нынче
carbon: carbon
dram: dram
привычный: привычную
периферия: периферия
atomic: atomic
позитивный: позитивные
снимок: снимков снимки
сценарий: сценариев
соперник: соперники
rgb: rgb
legend: legend
шестиядерник: шестиядерниками
дома: дома
wifi: wifi
пылева: пылевой
прогнозировать: прогнозирует
оплата: оплату
снижение: снижению
рабочий: рабочих
sberboom: sberboom
eb: eb
документ: документа
обвал: обвал
секрет: секреты
пользователь: пользователя
брутальность: брутальность
атмосфера: атмосферы
фс: фс
arc: arc
pro: pro
выдвижной: выдвижной
выносливый: выносливых
подписываться: подписаться
вывод: выводом
поднебесный: поднебесной
ftx: ftx
превышать: превысили
читатель: читателей
trendforce: trendforce
нный: нный
входить: войти
лошадь: лошадями
ifa: ifa
электромобиль: электромобилей
прибыль: прибыли
судя: судя
испарительный: испарительная
расширенный: расширенным
переживать: пережив
календарь: календарь
германия: германии
роглайк: роглайк
b: b
надзор: надзору
успевать: успели
сутки: сутки
полезный: полезные
samsung: samsung
space: space
забанить: забанила
обновла: обновл
adata: adata
crew: crew
мкс: мкс
oled: oled
уровень: уровней
сюрприз: сюрприз
рассматривать: рассматриваем
визуальный: визуальный
бывший: бывший
останавливаться: останавливается
разработчик: разработчиками
набор: набором набор
статья: статья
подтверждать: подтвердил
интрига: интригу
r: rss
разрабатывать: разработан
постановление: постановления
девяностый: девяностых
анонс: анонс
усиливать: усиливают
эл: эл
источник: источник источником
президент: президент
мкость: мкостью
hpc: hpc
новое: новое
нюанс: нюансы нюанс
тактический: тактическое тактический
расцвет: расцвета
hard: hard
выкладывать: выложенные
ситуация: ситуации ситуация
сша: сша
загрузка: загрузки
ippon: ippon
билайн: билайн
исчерпывать: исчерпывающим
ренессанс: ренессанс
глобальный: глобальной
cpu: cpu
наследие: наследия
эффектность: эффектность
цельный: цельных
вечерний: вечернем
азарт: азарт
превивать: превью
венера: венеры
продолжаться: продолжится
mini: mini
март: марта
генерировать: генерировать
опрос: опрос
интернет: интернете интернет
явно: явно
ия: ии
kc: kc
планшет: планшеты планшетов планшет
ltc: ltc
каждый: каждым каждый
linux: linux
превосходить: превосходит
проектор: проекторы
память: памяти память
biostar: biostar
криптовалюта: криптовалют
звук: звук
вступать: вступил
серый: серую
nvidia: nvidia
ламповая: ламповая
метановый: метановой
предварительный: предварительный
phantom: phantom
поступать: поступили
вода: воды
транзистор: транзистор транзисторы
стратегия: стратегии
fi: fi
индустриальный: индустриальные
twitter: twitter
тема: темы
dragon: dragon
наследник: наследник
уход: ухода
признавать: признавать
сравнение: сравнении
hi: hi
offсянка: offсянка
чжужун: чжужун
говорить: говорят
компьютер: компьютер
выяснять: выясняем
выясняться: выяснилось
неужели: неужели
готовиться: готовится
дыхание: дыхание
dread: dread
pioner: pioner
u: u
xenia: xenia
периодический: периодическое
хитрый: хитрой
посвящать: посвященном
tele: tele
tiger: tiger
знать: знает
конкурс: конкурсы
илона: илон
rtx: rtx
поговорить: поговорить
binance: binance
план: планы плане
tsmc: tsmc
социальный: социальные
м: м
таить: таить
россиянин: россиянином
прохождение: прохождение
лый: лый
сочетание: сочетанию
игровой: игрового игровой
юпитер: юпитера
настраивать: настроена
reconnaissance: reconnaissance
неутешительный: неутешительных
время: времена
letter: letter
computex: computex
фон: фоне
улучшать: улучшил
hardware: hardware
сулить: сулит
exascend: exascend
февраль: февраль феврале февраля
заметать: заметаем
зарядка: зарядки
участие: участие
копия: копий
час: часов
прислушиваться: прислушалась
отказываться: отказались
намек: намеки
kz: kz
выдерживать: выдержал
ждать: ждет ждали
шестой: шестые
ссылка: ссылка
honor: honor
индия: индия
openai: openai
долой: долой
наблюдать: наблюдать
развлекать: развлекать
необслуживаемый: необслуживаемого
криптобиржа: криптобиржи
новость: новости
тип: типа
уч: уч
материал: материале
мультитул: мультитулов
копирайт: копирайт
последний: последних
tdp: tdp
edge: edge
верн: верн
меркурий: меркурия
напряжение: напряжение
valve: valve
season: season
c: c
пароль: пароль
ряд: ряд
оказывать: оказывая
искусственный: искусственное
чиплет: чиплеты
сфера: сфере
pad: pad
пронзительный: пронзительных
автономный: автономный
наплыв: наплыв
pcie: pcie
hostkey: hostkey
пятнашки: пятнашек
индустрия: индустрии
плата: платы
ближний: ближний
технологический: технологической технологическое
хаос: хаос
сегмент: сегмент
кастомный: кастомные кастомных
попытка: попытка
программный: программное
офис: офиса
осмотр: осмотр
скупой: скуп
средний: среднего
сжо: сжо
вдыхать: вдохнуть
дайджест: дайджест
автор: автора
оказываться: оказаться оказался оказались
казаться: казалось
недостаток: недостатка
представление: представления
tecno: tecno
завтра: завтра
лидер: лидеры
несколько: несколько
добавлять: добавят добавит добавили
франциско: франциско
выдавать: выдано
восточный: восточные
рай: рай
new: new
вдвое: вдвое
откладывать: отложен
платформер: платформер
подход: подходе
pi: pi
hero: hero
kaixian: kaixian
выбиваться: выбиться выбилась
условие: условий
качество: качеству
простой: попроще
уничтожать: уничтожит
режим: режим
температура: температур
vk: vk
й: й
л: л
называть: называемых назвал
повторять: повторяет
расширять: расширили
payne: payne
информационный: информационная
е: е
май: мае
увеличивать: увеличить
dota: dota
nucleus: nucleus
авто: авто
трафик: трафика
попросту: попросту
tonk: tonk
потерпеть: потерпела
сервер: серверы
разнообразить: разнообразит
госуслуга: госуслуги
страница: странице страница
выстаивать: выстоит
разочаровываться: разочароваться
smart: smart
ремастер: ремастер
идти: идет
зона: зону
война: войне
nasa: nasa
неофициальный: неофициальный
отменять: отменена
сентябрь: сентября
кремниевый: кремниевого
xpg: xpg
торопиться: торопится
bandai: bandai
сво: сво
поменять: поменять
база: базе
conquest: conquest
рекордно: рекордно
max: max
поттер: поттера
стиль: стиле стиля
максимум: максимума
дисплей: дисплеев
заменитель: заменители
средневековый: средневековых
опоздание: опозданием
рные: рных
kx: kx
будущее: будущее
вновь: вновь
дело: деле
активный: активное активную
ошибка: ошибку
возобновлять: возобновил
полный: полное
точно: точнее
энтузиаст: энтузиасты
спрос: спроса
порядок: порядку
проверять: проверим
т: т
солнце: солнце
xeon: xeon
путь: пути путь
gen: gen
многие: многие
особенность: особенностями
lake: lake
корабль: корабля
грань: грань
порт: портами
защища: защищ
исходный: исходный
финт: финт
н: н
соединение: соединение
любитель: любителей
заимствование: заимствование
заявлять: заявил
обгонять: обогнал
обнаружение: обнаружения
мкие: мкие
открытый: открытого
взяться: взявшаяся
коллектив: коллектив
oreo: oreo
window: windows
digma: digma
р: р
термоядерный: термоядерный
привл: привл
партия: партию
elden: elden
rapid: rapids
сотрудничество: сотрудничество
ubuntu: ubuntu
известный: известных
наполнять: наполняет
грусть: грусть
vampire: vampire
андроид: андроид
нные: нные
законодательство: законодательства
клиент: клиентов
панель: панель
гкиа: гкий
прежде: прежде
действие: действию
видеодайджест: видеодайджесте
реальный: реальными
faraday: faraday
orbiter: orbiter
templar: templar
выпускать: выпустит
сделка: сделки
необитаемый: необитаемые
гигант: гигантам
предлагать: предложить
кабинет: кабинет
призывать: призвал
btc: btc
survival: survival
ti: ti
реальность: реальность
синтез: синтез
камера: камерой камера
ные: ные
наращивать: наращивает
саудовский: саудовской
эталонный: эталонных
поиск: поиск поиска
перетаскивать: перетаскивать
канал: каналы
прибавка: прибавку
информация: информацию
v: v
старый: старые
либо: либо
software: software
тестлаб: тестлабе
кадр: кадры
эксклюзив: эксклюзивом
технология: технологии технологий
файл: файлов
данные: данные
руководство: руководство
явь: явью
исследователь: исследователей
ракета: ракеты ракете
xbox: xbox
gigabyte: gigabyte
электрический: электрический
жизнь: жизнь
прямо: прямо
дрон: дронами
вероятный: вероятных
трассировка: трассировку
спортмастер: спортмастер
core: core
средневековье: средневековье
book: book
гостить: гостивший
сломать: сломанного
inkulinati: inkulinati
age: age
выживать: выживать
седьмой: седьмой
застой: застоя
ru: ru
прогноз: прогнозов
механизм: механизм
ных: ных
голова: голову
радиатор: радиатором
racing: racing
жидкостный: жидкостного
msi: msi
galaxy: galaxy
sprint: sprint
forum: forum
второй: второе
центр: центры
realme: realme
блэк: блэк
tesla: tesla
теплота: теплотой
симулятор: симулятор
аналог: аналог
тихий: тихого
представлять: представила представлена
мера: меры
луч: лучей
юридический: юридическая
впервые: впервые
бп: бп
обработка: обработки
p: ps
диагональ: диагональю
новостной: новостных
хакер: хакеров
десять: десять
яркий: яркий
надолго: надолго
мечта: мечта
стартовать: стартовали
полка: полок
федеральный: федеральной
поделиться: поделится
марка: маркой
работа: работе
патентный: патентная
рекорд: рекорд
запрещать: запретили
устройство: устройством
число: числе
cr: cr
намерен: намерена
алгоритм: алгоритма
хвалить: хвалят
geforce: geforce
искать: искать
опубликовывать: опубликовать
целое: целом
броский: броским
гаджет: гаджетах
миропорядок: миропорядке
указывать: укажите
ii: ii
спать: спящий
союз: союза
многий: многих
защищать: защитить
добиваться: добились
radeon: radeon
тонкий: тонкий
ископаемый: ископаемые
субфлагман: субфлагманах
вечный: вечной
зависимость: зависимости
все: всему
enermax: enermax
survivor: survivors
отключаться: отключился
азкабан: азкабане
онлайновый: онлайновых
спешить: спеша
обеспечение: обеспечение
silentown: silentown
насколько: насколько
гейтс: гейтс
итог: итоги
таможня: таможня
бюджетный: бюджетная
хоррор: хорроров
начинать: начала
ультрабук: ультрабук
новичок: новичку
фото: фото
вслед: вслед
красота: красота
след: след следы
x: x
telegram: telegram
меняться: менялись
вес: вес
код: код
соблюдение: соблюдением
запрягать: запрягала
power: power
мс: мс
изменять: изменяющий
неоднозначный: неоднозначные
apple: apple
большой: большой большие
недавно: недавно
hogwarts: hogwarts
облако: облака
ввоз: ввоз
сведение: сведения
ровер: ровер
остров: острова
конфиденциальность: конфиденциальности
буквально: буквально
финансы: финансы
пк: пк
имя: имя
охотник: охотников
обладать: обладает
функция: функции
перенос: перенос
корпус: корпуса
пообещать: пообещал
portal: portal
youth: youth
грезить: грезить
служить: служит
эра: эру
series: series
менять: менять
немой: нем
