татьяна: татьяна
тьютор: тьютор
нажимать: нажимая
пар: пар
возникать: возникающие возникнуть
неборский: неборская
составлять: составляет
противопоказание: противопоказания
мировой: мировое
детский: детском детского
подробно: подробнее
онлайн: онлайн
он: нему
ценность: ценности
личный: личное
дошколенок: дошколят
диагностика: диагностика диагностики
компания: компании
специалист: специалиста специалист специалисты специалистов специалисту
который: которую которые который которая
конференция: конференция
ребенок: ребенка детьми детей дети ребенку
филиал: филиалам филиал
именно: именно
душев: душев
железнодорожный: железнодорожный
средний: средней средняя
место: место
важно: важно
астроум: астроум
распознавать: распознавать
интелла: интелле
воспитатель: воспитатели
адаптироваться: адаптироваться
целый: целого
карта: карта
коуч: коуч
сад: сад саду
атмосфера: атмосфера
любой: любым
объяснять: объяснять
родительский: родительская родительские родительских
квартирник: квартирники
вливаться: влиться
образовательный: образовательных образовательная образовательного образовательной
пильский: пильская
незрелость: незрелость
качественно: качественно
получение: получению получении
отправлять: отправить
работать: работаем
видео: видео
астраханцев: астраханцева
воз: воз
железнодорожник: железнодорожников
профессиональный: профессиональной
ситуация: ситуацию
семья: семьи семей семья
начальный: начальной начальная
наш: наш нашему наши нашей
дева: дев
дошкола: дошколы дошкола
сентябрь: сентябрь
весна: весны
уровень: уровень уровня
основа: основы
оксана: оксана
реквизит: реквизиты
движение: движения
школа: школе школы школу школа
становиться: стала становятся
каждый: каждую каждый каждая каждого каждом
клуб: клуб
определенный: определенных
васильевна: васильевна
решать: решить решать
отмечать: отметила отметить
документ: документы
нулевой: нулевой
связываться: свяжемся
очень: очень
изыскивать: изыскивать
рисование: рисованием
находить: находить нашла найти
эмоция: эмоции
помогать: помогла помогает помогаем помочь помогающий
ранний: раннее ранняя
группа: группах группы группа
такой: такие
славин: славина
необходимый: необходим необходима
поступать: поступить
благодаря: благодаря
спать: спать
консультация: консультацию консультация консультаций консультации
отличный: отличная отличные
развитие: развитии развитие развитию развитием развития
жизнелюбие: жизнелюбие
задача: задач
индивидуальный: индивидуальная индивидуального
видеть: видят видеть
подходить: подойдут подходит
майндфулнесс: майндфулнесс
смелый: смелым
особенность: особенности особенностях
узнавать: узнала
сверстник: сверстниками
ложиться: лечь
глинтвейн: глинтвейн
дружно: дружно
педагог: педагог педагогам
олеговна: олеговна
идти: идти
результат: результата результате
концентрация: концентрации
субботний: субботние
николаевна: николаевна
академия: академия
самый: самое самые
креатив: креатива
море: моря
договариваться: договариваться
нку: нку
нейропсихология: нейропсихология
читать: читать
анатольевна: анатольевна
старший: старший
ул: ул
давать: даете
постановка: постановка
важный: важное
yandex: yandex
сессия: сессия сессии
музыкально: музыкально
действие: действиях действий
ребята: ребятами ребят
мама: маме мама
особый: особыми
бежать: бежит
записывать: запишем
елисей: елисей
тьюторский: тьюторское
уходить: уйти
образование: образовании образования
популярный: популярные
родитель: родителю родителям родителями родители родителей родителя
ролевой: ролевая
игровой: игровая
исследование: исследование
окружающий: окружающих
чжоу: чжоу
советский: советский
новое: нового
недолгий: недолгий
программа: программа программ
исследователь: исследователя
свой: своему своим своими своя свой
записываться: записаться
сенсорный: сенсорная
равно: равно
хотеть: хочу
внимание: внимание внимания
бабашка: бабашки
быть: будь
развивать: развивающие развивающая развивать
материнский: материнский
знание: знаний
суббота: субботам субботу
установление: установления
взять: взяли
готовый: готовы
подмосковье: подмосковье
быстро: быстро
заблаговременно: заблаговременно
промежуточный: промежуточной
рнутый: рнутой рнутая
вы: вами
мастерская: мастерская
младший: младшая
творческий: творческая
расказывать: расказала
капитал: капитал
выходной: выходной
центр: центра центр центре центров
устанавливать: установила
комплексный: комплексная
маршрут: маршрута
обращаться: обратились обратилась
рассказывать: рассказала рассказывает
тема: темы
благодарность: благодарность
свободный: свободная
умный: умная
сюжетный: сюжетно
разный: разного
потребность: потребностями
грамотность: грамотности
стесняться: стесняться
готовность: готовность готовности
трудность: трудности
проблема: проблемы
координатор: координатор
восторг: восторге
друг: друга друг
решение: решению
среда: среда среде
взай: взаи
супер: супер
марк: марк
отзыв: отзывы
сб: сб
герасимова: герасимова
человек: человеке людей человеком людям
вечер: вечер
приходить: пришло
каллиграфия: каллиграфии
сложность: сложности
обращать: обратить
данный: данных
утренник: утренниках
социализация: социализации
малыш: малыша малышу малышей
способствовать: способствуют
г: г
отказ: отказы
секунда: секунд
контакт: контакты контакт
поступление: поступлением поступлении
материал: материалов
вокал: вокал
доставка: доставка
анна: анна
упражнение: упражнений
рекомендовать: рекомендую
разработка: разработка
отставание: отставание
валентина: валентина
продленка: продленка
шорохов: шорохова
связанный: связано связанную связаны
правильный: правильный
научный: научная
литература: литературы
астреть: астрея
игра: игра
выходить: выходит
знающий: знающей
отказываться: отказываться
аппликация: аппликацией
персональный: персональных
желательно: желательно
повторять: повторять
совершенство: совершенству
вечеринка: вечеринка
проводить: проводить
школьник: школьников
год: год лет
директорский: директорский
стоимость: стоимость
коррекция: коррекцию
занятие: занятий занятия
праздник: праздник праздником
близкий: ближайшее
прямо: прямо
искусство: искусство
лиля: лиля
мочь: могут можем
вс: вс
ретроспектива: ретроспектива
возможнос: возможнос
какой: какую каких какие
взаимодействие: взаимодействии
огромный: огромное огромную
предел: предела
начинать: начал
м: м
положительный: положительная
речевой: речевой
вызывать: вызывает
рынок: рынке
наиболее: наиболее
оказывать: оказывает
организация: организации организация
стандарт: стандарты
позволять: позволяйте
креативный: креативные
опросник: опросник
обучение: обучении обучения
кнопка: кнопку
навык: навыков
существовать: существует
психоэмоциональный: психоэмоциональном
теплый: теплая теплые
понимать: понять понимать поняла
курс: курс
коучинг: коучинг
налоговый: налоговый
нка: нка
бодрый: бодрый
дорожный: дорожная
замечать: замечаю
заниматься: занимались
гюнай: гюнай
интенсив: интенсив
организовывать: организовывать
ru: ru
запуск: запуск
ваш: ваша вашему
разва: разв
расписание: расписание
уметь: умеет
довольный: довольный
цена: цены
фотогалерея: фотогалерея
ребеночек: детки
макаров: макарова
наблюдаться: наблюдалось наблюдается
легко: легко
музыка: музыка
жизнь: жизни жизнью
логоритмика: логоритмика
воскресение: воскресенье
маргарита: маргарита
нормативный: нормативные
личностный: личностному
ковязин: ковязина
красноярск: красноярска
эмоциональный: эмоциональный
лицензия: лицензия лицензии
партнер: партнеры
приходько: приходько
процесс: процесс
родительство: родительства
посещение: посещения
ночевка: ночевка
ольга: ольга
реб: реб
хотеться: хочется хотелось
первый: первая
оставлять: оставьте
практика: практик
финансовый: финансовой
считать: считаю
процветание: процветания
раса: рас
пара: пару
ващенко: ващенко
студия: студия
трансформация: трансформация
чтение: чтения
это: это
бахотский: бахотскому
песочный: песочная
час: часов час
компетенция: компетенций
уютный: уютные
день: день
нке: нке
атмосферный: атмосферное
работа: работы работа работе
нейропсихолог: нейропсихолог нейропсихолога
мозговой: мозговая
семейный: семейных семейный
рост: роста росту
прекрасный: прекрасное
менеджер: менеджер
фгос: фгос
правило: правила правило
список: список
сеть: сети
главное: главное
интеграция: интеграция
определять: определять
вычет: вычет
библиотека: библиотека
бэби: бэби
написать: написать
частный: частную частная
ученик: учеников
девчонка: девчонкам
русский: русского
галина: галина
бесплатный: бесплатный
дулинец: дулинец
учебный: учебный
оплата: оплата
услуга: услуги
знать: знаю
мы: нам
заявка: заявку
сопровождение: сопровождение
любимый: любимым любимый
профориентация: профориентация
политика: политика
тренировка: тренировка
лицо: лицах
понравиться: понравилось
диагностировать: диагностировать
событие: события
корректировать: корректировать
время: время
запись: запись
уч: уч
дело: дело
мой: моему
высота: высоте
коррекционный: коррекционные
анастасия: анастасией анастасия
новый: новой
секретный: секретные
класс: классы класс классов
мальчик: мальчику
новорожденный: новорожденным
экспресс: экспресс
род: рода
отношение: отношения отношении
генеральный: генеральный
поддержка: поддержку
ко: ко
переставать: перестал
сильно: сильно
обсуждать: обсудят
ментальный: ментальная
павловский: павловская
увидеть: увидеть
мысль: мысли
обработка: обработку
пн: пн
целое: целом целое
разъяснение: разъяснения
coach: coach
добрый: добрый
нком: нком
душевный: душевная
заказывать: заказать
георгиевна: георгиевна
подготовка: подготовки подготовка
вакансия: вакансии
культура: культуры
зрелость: зрелость
единый: единое
евросад: евросад
чувствовать: чувствовать
терапия: терапия
тренинг: тренинги тренинг
правовой: правовая
минус: минус
сингапурский: сингапурская
удовольствие: удовольствием
марафон: марафон
встреча: встречи
проконсультировать: проконсультируем
немаловажный: немаловажно
город: города
босой: бос
курсы: курсы
практический: практический
четко: четко
далее: далее
логопед: логопеда логопед
другой: другими
большой: большое
увлечение: увлечение
еврокласс: еврокласс
вклад: вклад
завтра: завтра
ожидание: ожидания
лаборатория: лаборатория
руководитель: руководитель руководителю
win: win
методика: методика методики
вопрос: вопросы
мероприятие: мероприятий
возможность: возможности
команда: команда
пространство: пространство
клиент: клиент
волноваться: волнуется
вернуться: вернуться
второй: второй
влиять: влияет
рекомендация: рекомендациями
заманивать: заманивает
нок: нок
квест: квест
твой: твои твоей
интересный: интересный
акция: акции
путь: путь
район: район
слабовидящий: слабовидящих
информация: информация
цифра: цифрах
правильно: правильно
интеллект: интеллект
подход: подход
заинтересовывать: заинтересован
осознанность: осознанности
хвалить: хвалить
center: center
стихотворение: стихотворения
эффективно: эффективно
кафе: кафе
речь: речи
администратор: администратор
детско: детско
выражать: выразить
прогуливаться: прогуляться
посещать: посещаем
смотреть: смотреть
бережная: бережная
наталья: наталья
соответственно: соответственно
е: е
детство: детство
динамика: динамика
вперед: вперед
понимание: понимание
согласие: согласие
андреевна: андреевна
дарья: дарья
театр: театра
все: всем
версия: версия
ресурс: ресурсов
certified: certified
мини: мини
галактика: галактика
проведение: проведения
спасибо: спасибо
откуда: откуда
александровна: александровна
nbsp: nbsp
форсайт: форсайт
уверенный: уверенной
деятельность: деятельности
актер: актеров
покоряться: покоряются
эффективный: эффективной
сведение: сведения
ещ: ещ
участвовать: участвовали
нк: нк
неприемлемость: неприемлемость
педагогический: педагогическое
юлия: юлия
аттестация: аттестации
выступление: выступлениях
февраль: февраль
арифметика: арифметика
план: план
конфиденциальность: конфиденциальности
ивановна: ивановна
вебинара: вебинары
кратковременный: кратковременного
аврелий: аврелий
необходимо: необходимо
требоваться: требуется
ораторский: ораторское
власова: власова
дмитриевна: дмитриевна
период: период
театральный: театральная
сво: сво
серьезный: серьезное
марламова: марламова
нейрокоррекция: нейрокоррекция
поговорить: поговорят
лепка: лепкой
уникальный: уникальна
обращение: обращение
психолог: психолога психолог
помощь: помощь
дальнейший: дальнейшем
хватать: хватает
женский: женский
инсайт: инсайтов
направлять: направлены
звук: звуков
василиса: василиса
елена: елена
блог: блог
директор: директор
пребывание: пребывания
иметься: имеются
