фастфудный: фастфудной фастфудная
комиссариат: комиссариаты
тонизирующий: тонизирующие
самообслуживание: самообслуживания
население: населения
гэс: гэс
оскол: оскол
биологически: биологически
гидроабразивный: гидроабразивная
бар: бары
сауна: сауны саун
химия: химия
мотошкола: мотошколы
сигарета: сигареты сигарет
елец: елец
ломбард: ломбарды
ульяновск: ульяновск
зависимость: зависимостей
котел: котлы
такелажный: такелажные
детский: детских детские детское
платье: платьев
товарищество: товарищества
специя: специи
дон: дону
аварийный: аварийные аварийных
офтальмолог: офтальмолога
автоэмаль: автоэмали
аутсорсинг: аутсорсинг
новороссийск: новороссийск
многоквартирный: многоквартирных
холодильный: холодильное
соевый: соевые
реконструкция: реконструкция
прибор: приборы приборов
область: область области
планирование: планирования
специализированный: специализированные специализированное
отход: отходов отходами
ответ: ответ
заказчик: заказчиков
настольный: настольных настольные
смесь: смеси
контакт: контактов
балаково: балаково
полный: полного полная
инвентаризация: инвентаризация
открываться: открывается
стриптиз: стриптиз
моментально: моментально
литература: литература
ремонт: ремонту ремонта ремонт
фондовый: фондовом
ипотека: ипотеки
мобильный: мобильных мобильным мобильные
краска: краски
общественный: общественного общественные общественное
оформление: оформление оформлении оформления
имидж: имидж
идентификатор: идентификатор
менее: менее
досуговой: досуговые
туалет: туалеты
порошковый: порошковая порошковые
киоск: киоски киосков
взрывной: взрывные
промоушн: промоушн
световой: световая световое светового
автогрузоперевозка: автогрузоперевозки
изыскание: изысканий
реклама: рекламы реклама
предоставлять: предоставляете предоставляемая
охрана: охрана охране охраны
изображение: изображений
масло: масла
радиотелефон: радиотелефоны
пользование: пользования
такой: таких такими такие
иномарка: иномарок
творчество: творчества
обязательный: обязательного
администрация: администрации администрация
компьютерный: компьютерные компьютерных компьютерная
яма: ям
инфракрасный: инфракрасных
гостиница: гостиницы гостиниц
грузопод: грузоподъ
пряжа: пряжа
получать: получить получу полученную получил
спортивный: спортивная спортивный спортивное спортивно спортивного спортивные спортивных
прогимназия: прогимназии
украшение: украшения
часовня: часовни
материал: материал материалов материалы
дорожный: дорожного дорожные
снег: снега
безопасность: безопасности безопасность
весовой: весовое
целиком: целиком
лаборатория: лаборатории лабораторий
патентный: патентные
антиквариат: антиквариат
брянск: брянск
хороший: хорошим
измерительный: измерительный измерительные измерительных
постамата: постаматы
протезный: протезные
магазин: магазины магазинов
бескаркасный: бескаркасная
подсветка: подсветка
фотокабина: фотокабины
страхование: страхование страхования
ювелирный: ювелирных ювелирного ювелирные
малоэтажный: малоэтажных
мочь: могут можете
полезный: полезных
активный: активные активных
вторичный: вторичные
доступный: доступна
девелоперский: девелоперские
результат: результатов
автоковров: автоковров
одежда: одежды одежда
макет: макетов
миколог: миколога
email: email
железобетонный: железобетонные
аквапарк: аквапарки аквапарков
внешнеэкономический: внешнеэкономической
мник: мник мники
институт: институты
государственный: государственного государственные
очиститель: очистители
вызов: вызова
компьютер: компьютеров компьютеры
ежемесячно: ежемесячно
салон: салонов салоны
скидка: скидки скидкой скидка скидками
рассматривать: рассмотрим
процедура: процедуры
травматология: травматология
рные: рные
новокузнецк: новокузнецк
медицинский: медицинское медицинского медицинские медицинская медицинских
негосударственный: негосударственные
третий: третьих
изоляционный: изоляционные
запчасть: запчасти
жные: жные жных
наш: нашей наши нашего
фитопродукция: фитопродукция
пиф: пифы
швейный: швейные швейная швейное
пожарный: пожарных пожарная
керамогранит: керамогранит
право: права правам
лагерь: лагеря
фасад: фасады
учреждение: учреждений учреждение учреждения
ваш: вашего ваша ваш вашей
охотничий: охотничьи
бровь: бровями
авторский: авторских
надзор: надзор надзора
предприятие: предприятий предприятия
бухгалтерский: бухгалтерские
россия: россии
телефония: телефония
приходить: пришел
автомойка: автомойки автомоек
кирпич: кирпич
входной: входные
сексолог: сексолога
полиция: полиции
автоматизированный: автоматизированные
тампопечать: тампопечать
озеленение: озеленение
контора: конторы
старый: старше старых старый
груминг: груминга
вы: вами
новый: новый новая
кофейня: кофейни
раздел: разделах раздел разделе
оплата: оплаты оплате
армавир: армавир
пылеудаление: пылеудаления
валюта: валюты валют
деревообработка: деревообработка
памятник: памятники памятников
красота: красоты красота
антенный: антенного антенное
часы: часы
инструмент: инструменты инструментов инструмент
территориальный: территориальные
кострома: кострома
декоративный: декоративных декоративные
балкон: балконов
региональный: региональной
лотерея: лотереи
животноводство: животноводство
автосервис: автосервис автосервиса
применение: применения
служба: службы
повышение: повышение повышения
группа: группы
хлебобулочный: хлебобулочные
горячий: горячих
ситуация: ситуаций
техобслуживание: техобслуживание
телефон: телефонам телефоны телефонов телефонами
резинотехнический: резинотехнические
законодательный: законодательная
деревянный: деревянная
инвестиционный: инвестиционные инвестиционных
кухня: кухни
энергосбережение: энергосбережения
газоход: газоходов
раствор: раствор
защитный: защитные
рыба: рыба
остеопат: остеопата
экстренный: экстренные экстренного
городской: городского городской городские
сувенир: сувениры сувениров
дерматовенеролог: дерматовенеролога
продукция: продукция продукции
русский: русскому
производство: производства производство
возможность: возможности возможностями
благоустройство: благоустройство
тные: тные
электроника: электроника
накладной: накладные
подолог: подолога
оренбург: оренбург
сельскохозяйственный: сельскохозяйственного сельскохозяйственные
авиаоборудование: авиаоборудование
заточка: заточка
речной: речные
указывать: указав
календарь: календари
тестирование: тестирование тестирования
участок: участков участки
повтор: повторы повторов
занятие: занятия
свадебный: свадебных свадебные
гирудотерапевт: гирудотерапевта
комендатура: комендатура
орех: орехи
портьерный: портьерные
лор: лор
тоннель: тоннелей
азс: азс
искусство: искусство искусств
оперативный: оперативная
абразивоструйный: абразивоструйное
кадетский: кадетские
тело: телу
обслуживание: обслуживание
рынок: рынке рынках рынки
организация: организации организаций организация
подольск: подольск
обучение: обучение обучении обучения
кэс: кэс
деколирование: деколирование
грузоперевозка: грузоперевозок грузоперевозки
автомобильный: автомобильной автомобильные
также: также
комиссия: комиссии
ручной: ручной
начальный: начальные
расчет: расчет
учебный: учебные учебных учебная
йога: йоги
войлочный: войлочные
арматура: арматура
недвижимость: недвижимости недвижимость
культурно: культурно
один: одни одна
перевозка: перевозке перевозка перевозки
дверь: двери дверей
ч: ч
креп: креп
печатный: печатных печатной
геологоразведочный: геологоразведочные
строительство: строительства строительство
подшипник: подшипники
краснодар: краснодар краснодара
детективный: детективные
актау: актау
садовый: садово
стивидорный: стивидорные
водоснабжение: водоснабжение водоснабжения
реестр: реестра
умвд: умвд
защита: защиты защита
фулфилмент: фулфилмент
похороны: похорон
огнеупорный: огнеупорные
тур: туров туры
полиграфический: полиграфические полиграфическое
финансовый: финансовые финансовых финансовый
шерегеш: шерегеш
верхний: верхняя
кемерово: кемерово
спецобувь: спецобувь
радио: радио
пригождаться: пригодиться
выездной: выездная выездные
новошахтинск: новошахтинск
мебель: мебель мебели
аэрос: аэросъ
стекло: стекла стекло
фотос: фотосъ
ложь: лжи
очки: очков очки
кол: кол
инстапринтер: инстапринтеры
род: родов
комиссионные: комиссионные
газета: газеты
оплачивать: оплачиваете оплатить оплатил
комбинат: комбинаты
cd: cd
металл: металлов металла металлы
работа: работы работа
вспомогательный: вспомогательные
жать: жмете
добавка: добавки
нутрициология: нутрициологии
дело: дел
значит: значит
уверять: уверены
лекарственный: лекарственных лекарственные
телеканал: телеканалы
расширять: расширить
например: например
правило: правило
строительный: строительные строительных строительное
усть: усть
дорога: дороге дорогу дорог
источник: источников источники
шина: шин шины
электродвигатель: электродвигатели электродвигателей
практик: практики
грязепоглощающий: грязепоглощающие
геологический: геологические
стекломагнезитовый: стекломагнезитовые
сэндвич: сэндвич
экологический: экологическая экологические
провод: провод
выделять: выделите
промышленность: промышленности
стоматологический: стоматологические стоматологическое
электросеть: электросетей
вечерний: вечерних
послепечатный: послепечатная
мы: нам
забор: заборы
интеллектуальный: интеллектуальные
гостевой: гостевые гостевых
клей: клеи
тепловой: тепловое
блок: блоки
оргтехника: оргтехники оргтехника
сурдолог: сурдолога
патронажный: патронажные
круиз: круизы
покупка: покупки покупку покупкой покупке покупка
конный: конные конного
печать: печать печати печатей
камень: камень камня камни
допуск: допуска
ортопедия: ортопедия
структура: структур
этот: эта
экспресс: экспресс
выставка: выставок выставки
сургут: сургут
власть: власть власти
капремонт: капремонт
предмет: предметы
образование: образование
лодочный: лодочные
проектный: проектной
уполномоченный: уполномоченных
установка: установки установка установке
прачечная: прачечные прачечных
коммерческий: коммерческое
ма: ма
дача: дач
кормовой: кормовые
телефонный: телефонных телефонной
открытый: открытых
почтовый: почтовый почтовые
электроизоляционный: электроизоляционные
сланцы: сланцы
судебный: судебная судебных судебные
диспетчерская: диспетчерские
травмпункт: травмпункты
сумма: сумма
авиакомпания: авиакомпании
энергоаудит: энергоаудит
проездной: проездные
управление: управление управления
сетевой: сетевое
теплица: теплицы
косметолог: косметолога
назначение: назначения
модель: модели
регистрация: регистрации регистрация
элиста: элиста
провайдер: провайдеры
тренинг: тренинги
индивидуальный: индивидуального индивидуальной
виртуальный: виртуальные
переподготовка: переподготовка
остекление: остекление
использовать: использовать использует
пиявка: пиявки
иваново: иваново
медицина: медицина медицины
вум: вум
приход: приходы
рукоделие: рукоделия
город: городу городов город городам города
курсы: курсы
кладбище: кладбища
калуга: калуга
головной: головные
фотошкола: фотошколы
тэц: тэц
лестница: лестницы
бытовой: бытовая бытовой бытовые
выбирать: выбрали выбрать выбранный выберите
междугородный: междугородные
акция: акций
нефтебаза: нефтебаз
пол: полов
шымкент: шымкент
гумвд: гумвд
уборка: уборка
санаторий: санатории санаториев
назрань: назрань
элефант: элефант
интернат: интернаты
вид: видов
экспедирование: экспедирование
сборка: сборка
питание: питание питания
буровой: буровое буровые
отделение: отделения
вредитель: вредителей
тротуарный: тротуарная
пенсия: пенсий
полиграфия: полиграфия полиграфии
геофизический: геофизические
сервер: сервера
гсм: гсм
наливной: наливных
эротический: эротические
приобретать: приобретаете
сайт: сайтов сайты сайте
скалодром: скалодромы
браться: берется
голографический: голографическая
кредитный: кредитных кредитные
велнес: велнес
вендинговый: вендинговое
кулинария: кулинария кулинарии
ревматолог: ревматолога
лотерейный: лотерейных
указываться: указываются
взрослый: взрослые взрослых
мка: мка
удалять: удалить
ликвидация: ликвидация
устаревать: устаревшая устаревшие
кафель: кафель
водный: водно водные водных
камчатский: камчатский
муром: муром
огородный: огородного огородный
обусловливать: обуcловлены
работать: работает
галерея: галереи
административный: административных
инвентарь: инвентарь инвентаря
керамический: керамические керамическая
домашний: домашних домашний
глаз: глаза
алкогольный: алкогольные
ограниченный: ограниченными
проверять: проверяйте проверьте проверенных
оборудование: оборудование оборудования
горпо: горпо
компания: компании компаний компания
файл: файл
антикоррозийный: антикоррозийная
культура: культуры культура
кабинет: кабинета
антикафе: антикафе
коктейль: коктейлей
согласование: согласование
омск: омск
звукоизоляционный: звукоизоляционные
мост: мостов
мэйл: мэйл
сценический: сценических сценические
map: maps
первый: первую первый
аромамаркетинг: аромамаркетинг
грэс: грэс
южный: южно
добыча: добычи добыча
точка: точки
панель: панели
геодезический: геодезическое геодезические
канцелярский: канцелярские
рязань: рязань
ветеринарный: ветеринарно ветеринарной ветеринарные
комикс: комиксы
ярославль: ярославль
аренда: аренда
туризм: туризма туризм
прочистка: прочистка
мдф: мдф
другой: других
покупать: покупаете
ленинск: ленинск
автомобиль: автомобилей автомобиля
ok: ok
профессиональный: профессиональная профессиональные
игровой: игровое игровые
лицей: лицеи
подводный: подводного подводно
пульмонолог: пульмонолога
деятельность: деятельности
земельный: земельных
тонирование: тонирование
жир: жир
роллердрома: роллердромы
генетика: генетика
bazagis: bazagis
великий: великий
нумизматика: нумизматика
рабочий: рабочим
поверка: поверка
бетоносмесительный: бетоносмесительные
банковский: банковского банковское
соляной: соляные
информационный: информационные информационная информационных
международный: международные
личностный: личностные
автосигнализация: автосигнализации
штора: шторы
микрофинансирование: микрофинансирование
измерение: измерение
изделие: изделий изделия
букмекерский: букмекерские
ингредиент: ингредиенты
подготовка: подготовка
иммунизация: иммунизации
военный: военно военная военные
погонажный: погонажные
напольный: напольные напольных
гражданин: граждан
лист: листы
лечение: лечения лечение
самогоноварение: самогоноварения
инженерный: инженерные инженерных
трубопровод: трубопровода
чс: чс
плет: плет
киргизия: киргизии
минута: минут минуты
указанный: указанный
стеллаж: стеллажи
быстрый: быстрого
ягода: ягоды
магнит: магниты
подписка: подписке
совместный: совместному совместные
кофемашина: кофемашины
москва: москва
консервированный: консервированная
обращение: обращение
дизельный: дизельных дизельное
патриотический: патриотические
садоводческий: садоводческие
помощь: помощь
харьков: харьков
автоприцеп: автоприцепы
оффлайн: оффлайн
унт: унты
шиномонтаж: шиномонтаж
рубеж: рубежом
морской: морские морских
игротека: игротеки
быстровозводимый: быстровозводимые
пример: пример примеры примере
край: края
уральск: уральск
дубл: дубл
социологический: социологические
оценка: оценка
подвесной: подвесные
топливо: топливо
парикмахерская: парикмахерские
камин: камины
свежий: свежие
налоговый: налоговые
супермаркет: супермаркеты
столбец: столбец
e: e
автокомплектующий: автокомплектующих
пенсионный: пенсионные
газовый: газовое газового
борьба: борьбы
онлайн: онлайн
пластмасса: пластмасс
димитровград: димитровград
аппарат: аппаратов аппараты
физиотерапевт: физиотерапевта
здание: зданий здания
рассылка: рассылка
мки: мки
лыжный: лыжные
самара: самара
киев: киев
хирург: хирурга
морепродукт: морепродукты
гриб: грибы
количество: количество
петрозаводск: петрозаводск
репетиционный: репетиционные
термотрансфер: термотрансфер
карта: карты карт
видео: видео
рный: рный
женщина: женщин
аквариум: аквариумов аквариумы
коворкинг: коворкинг
фототовары: фототовары
почта: почта
говорить: говоря
зал: залы
психотерапевт: психотерапевта
силовой: силовых
схождение: схождение
гинеколог: гинеколога
скобяной: скобяные
ресторан: рестораны ресторанов
облицовочный: облицовочный облицовочные
костюм: костюмы
документ: документов документы
чистка: чистка
ст: ст
следующий: следующие
ногтевой: ногтевые
теплоснабжение: теплоснабжение
оптика: оптика
ребенок: детей
грузовой: грузовые грузовых
аквапечать: аквапечать
язык: языков языку
гигиена: гигиены
внесудебный: внесудебная
технический: технический технические техническая техническое
развитие: развития
мягкий: мягкая
поликлиника: поликлиники
инжиниринговый: инжиниринговые
потенциальный: потенциальных
лечебный: лечебной
автост: автост
безналичный: безналичный
аттракцион: аттракционы аттракционов
алтай: алтай
средство: средства
избавляться: избавиться
кузнецкий: кузнецкий
авторазбор: авторазбора
разработка: разработка разработке
кожаный: кожаное кожаные
шипчандлерский: шипчандлерские
журнал: журналы
видеотехника: видеотехника
свайный: свайные
национальный: национальных национальная
обзвон: обзвон
экспертиза: экспертиза экспертизы
нки: нки
ростов: ростов
история: истории историй
железнодорожный: железнодорожного железнодорожное железнодорожных железнодорожные
витраж: витражей
лофт: лофтов
мозаика: мозаики
аутдор: аутдор
кот: кота
термопечать: термопечать
упаковочный: упаковочное упаковочные
кожа: кожа
копировальный: копировальные
тюмень: тюмень
японский: японской
шейный: шейные
вязание: вязание
трудоустройство: трудоустройству
насосный: насосное
наружный: наружных наружная наружной
природоохрана: природоохраны
досуговый: досуговых
bd: bd
кровельный: кровельные
пассажирский: пассажирские пассажирского
продажа: продажа продаже продажи
автобусный: автобусные
дубликат: дубликаты
цветок: цветы цветов
скачать: скачать скачанном
принадлежность: принадлежности
конструкторский: конструкторские
очистный: очистные
федеральный: федеральные
игра: игры игр
коллектив: коллективы
справочный: справочные справочно
поездка: поездки
малярный: малярный
связь: связь связи
исследовательский: исследовательские
абакан: абакан
штамп: штампов штампы
белгород: белгород
теннисный: теннисные
диагностический: диагностические
пивоварение: пивоварения
презентационный: презентационного
судостроение: судостроение
корпусной: корпусная
spa: spa
авиагрузоперевозка: авиагрузоперевозки
бад: бад
дошкольный: дошкольных
бомбоубежище: бомбоубежища
перегородка: перегородок
занимать: занять
юридический: юридическое юридические юридических
срок: сроки
пластиковый: пластиковых пластиковая
отопление: отопления
версия: версии
диапазон: диапазон
удэ: удэ
консультант: консультанта консультантов
нефтяной: нефтяные
сми: сми
песок: песок
рюмочный: рюмочные
яйцо: яйцо
садиться: сел
товар: товаров товары
разливный: разливного
двор: двора
улица: улиц
акимат: акимат
перевод: переводов перевод
спецтехника: спецтехника спецтехники
автокондиционер: автокондиционеров
очистка: очистка очистки
гастроэнтеролог: гастроэнтеролога
доставка: доставка доставки
автоматический: автоматические
шлагбаум: шлагбаумы
радиостанция: радиостанции
пневматический: пневматическое
семечко: семечки
диетология: диетологии
ухта: ухта
офсетный: офсетная
сварочный: сварочное сварочные
сад: сад сады
рубрика: рубриках рубрики рубрику рубрик
азиатский: азиатской
телевидение: телевидения
ноябрьск: ноябрьск
санкт: санкт
кадровый: кадровые
шатер: шатров
концертный: концертные концертных
автозвук: автозвук
сейф: сейфы
рыбалка: рыбалки
петропавловск: петропавловск
волос: волосы
сельский: сельского
адвокат: адвоката
мастерская: мастерские
стоимость: стоимость
наполнение: наполнению
обмен: обмена обмен
семя: семена
крупа: крупы
развлечение: развлечения
выставочный: выставочное
роспись: росписи
минеральный: минеральная
тимбилдинг: тимбилдинг
тула: тула
франшиза: франшиз
информация: информацию информации информация
наиболее: наиболее
бункеровка: бункеровка
котельный: котельное
управлять: управляющий
студия: студии
палата: палаты
кнопка: кнопку
двп: двп
валяльный: валяльно
психолого: психолого
поисковый: поисковые
писать: пишите
проекционный: проекционное
домофон: домофоны
архангельск: архангельск
картинг: картинг
мной: мное
заправка: заправка
трамвайный: трамвайные
картографический: картографическая
уфа: уфа
конференц: конференц
снг: снг
опора: опоры
формировать: формируете
таргетинговый: таргетинговая
металлоконструкция: металлоконструкции металлоконструкций
покрытие: покрытий покрытия
услуга: услуга услуги услуг
подогреватель: подогреватели
троллейбусный: троллейбусные
терминал: терминалов терминалы
аудио: аудио
вышивка: вышивки
невролог: невролога
реб: реб
выгрузка: выгрузки
заправочный: заправочные заправочных
диализный: диализные
дата: дата
творческий: творческие
картина: картин
социальный: социальные социальной социального
дезинфекция: дезинфекция
мотомасло: мотомасла
аптека: аптеки
растение: растений
беременность: беременности
необходимый: необходимы
сертификат: сертификатов
камышин: камышин
нефтегазодобывающий: нефтегазодобывающих
каркасный: каркасно
табло: табло
документация: документации
главное: главное
торговый: торговые торгового торгово
матрас: матрасы
стрелковый: стрелковые
персонал: персонал
комсомольск: комсомольск
бурение: бурение
диджей: диджеев
порядок: порядка
окраска: окраска
пенза: пенза
сообщение: сообщение
округ: округов округа
яхта: яхт
фрукт: фрукты
нижневартовск: нижневартовск
авторемонт: авторемонт
напиток: напитков напитки
билет: билетов билеты
оркестр: оркестры
велосипед: велосипеды
способ: способах
труба: трубы
санитарный: санитарного санитарно санитарные
обувной: обувные обувная
сыр: сыры
электроизмерительный: электроизмерительные
папка: папке папку
уральский: уральский
тиражирование: тиражирование
район: районов
видеоигр: видеоигр
флажок: флажок
база: базы базу база базой базе
диагностика: диагностика
врач: врача
газоснабжение: газоснабжения
активно: активно
светотехника: светотехника
жестяной: жестяная
баня: бань бани
киров: киров
профпатолог: профпатолога
лицензирование: лицензирование
контроль: контроль контроля
гидрогеологический: гидрогеологические
кооператив: кооперативы
судоремонт: судоремонт
владимир: владимир
орск: орск
физкультура: физкультурой
эпилептолог: эпилептолога
моделирование: моделирование
транспорт: транспорт транспорта транспорте
интерес: интересом
нанесение: нанесение нанесения
вентиляционный: вентиляционное
каталог: каталогами
омвд: омвд
астрахань: астрахань
номер: номер
меховой: меховые меховых меховое
хозяйственный: хозяйственные хозяйственных
металлолом: металлолома
google: google
днепр: днепр
театральный: театральных театральные
вывоз: вывоз
солнцезащитный: солнцезащитные
филателия: филателия
танец: танцам танцев
пикалево: пикалево
препарат: препараты препаратов
гематолог: гематолога
правительство: правительство
рем: рем
чай: чай
процессинговый: процессинговые
водитель: водителя
продовольственный: продовольственных продовольственные
письмо: письма письмо
кованый: кованые
таганрог: таганрог
текстиль: текстиля текстиль
кулер: кулеров
молитвенный: молитвенные
резать: режущих
ворота: ворота
религиозный: религиозные
металлообработка: металлообработка
сельхозтехника: сельхозтехнике сельхозтехника
уссурийск: уссурийск
бижутерия: бижутерия
проведение: проведение
кинотеатр: кинотеатры
снос: снос
реабилитация: реабилитации
мара: мар
новосибирск: новосибирска новосибирск
клиент: клиент клиентов
бензиновый: бензиновых бензиновое
гофротара: гофротара
инкубатор: инкубаторы
гидравлический: гидравлическое
дистанционный: дистанционного
внутренний: внутренних внутреннего
заказ: заказа заказов заказ
заведение: заведения
компрессорный: компрессорное
чулочный: чулочно
станция: станции станций
парик: парики
кафе: кафе
электронный: электронных электронные
хранение: хранение хранения
универсальный: универсальные
обеспечение: обеспечения
мкпп: мкпп
шахтный: шахтное
находить: найдете
цикл: цикла
нефтедобывающий: нефтедобывающие
крюинговый: крюинговые
представительство: представительства
подключение: подключении
сырь: сырь
уренгой: уренгой
электротехнический: электротехническая
инфокоммуникационный: инфокоммуникационные
оптик: оптики
гидромассажный: гидромассажное
женский: женская женские
тюнинг: тюнинг
водительский: водительского
сыктывкар: сыктывкар
кожгалантерея: кожгалантерея кожгалантереи
часть: части
утилизация: утилизация утилизации
санфаянс: санфаянс
полимерный: полимерных полимерная
герметик: герметики
ола: ола
перепланировка: перепланировок
дома: дома
широкий: широка
аукцион: аукционов
мясо: мясо
коллагенария: коллагенарий
андролог: андролога
парфюмерия: парфюмерия
пересекаться: пересекаться
ор: ор
инкассация: инкассации
аккумулятор: аккумуляторы
дымоход: дымоходов
грозный: грозный
приготовление: приготовления
стеклопластик: стеклопластика
газодобывающий: газодобывающие
туроператор: туроператоры
религия: религия
линза: линзы
фонд: фонды фонд
зерноотходы: зерноотходы
аэропорт: аэропорты
табачный: табачные
бумажный: бумажная
тверь: тверь
сервис: сервисы сервиса
хозяйство: хозяйства
авиационный: авиационные
сочи: сочи
тот: те та
преимущество: преимущества
торговля: торговли
училище: училища
нужно: нужно
реактив: реактивы
боулинг: боулинг
мех: меха
упаковка: упаковка упаковке
временный: временного
электроустановочный: электроустановочная
уф: уф
караоке: караоке
благовещенск: благовещенск
клининговый: клининговое
сухофрукты: сухофрукты
окно: окон окна
воронеж: воронеж
забирать: забрать
сахалинск: сахалинск
складской: складского
аквасистема: аквасистем
контактный: контактные
пчеловодство: пчеловодства
прогулка: прогулки
киноаттракцион: киноаттракционы
металлический: металлическая
зонтов: зонтов
сухой: сухие
психолог: психолога
милиция: милиции
мототехника: мототехники мототехника
терапевт: терапевта
устройство: устройств устройству устройства
администрирование: администрирования
три: трех
ограждение: ограждения
светоотражающий: светоотражающие
питомец: питомцы
жилищный: жилищное жилищно
питьевой: питьевая
сеть: сетей
филармония: филармония
инжектор: инжекторов
лакокрасочный: лакокрасочные
музей: музеи
психиатр: психиатра
щебень: щебень
судовождение: судовождению
педагогический: педагогические
дом: домов дом
лицо: лиц
металлоискатель: металлоискатели
поле: поле
терапия: терапии
лесоматериал: лесоматериалы
гипермаркет: гипермаркеты
mail: mail
хостинг: хостинг
животное: животными
калибровка: калибровка
контрольный: контрольно
путь: путей
ископаемое: ископаемых
авиабилет: авиабилеты
джинсовый: джинсовая
костанай: костанай
спутниковый: спутниковая
орел: орел
телекомпания: телекомпании
межкомнатный: межкомнатные
об: объ
трейдинг: трейдингу
хенд: хенд
секция: секции
фасовочный: фасовочно
барокамера: барокамера
гараж: гаражей
купля: купли
псков: псков
нальчик: нальчик
райпо: райпо
бриллиант: бриллиантов
модернизация: модернизация
автостекло: автостекло
инспекция: инспекции
охота: охоты
какой: каком
электрооборудование: электрооборудование
монтаж: монтаж
поддержка: поддержка
уход: уходу
система: систем системы
сотрудник: сотрудников
бетон: бетон
мебельный: мебельные мебельная
промышленный: промышленных промышленные промышленная промышленного промышленной промышленный промышленное
духовный: духовные
огнезащитный: огнезащитная огнезащитные
центральный: центрального
саранск: саранск
освещение: освещения
тупик: тупика
автоэлектрик: автоэлектрики
консультация: консультации
легковой: легковых легкового
фирма: фирма
оргстекло: оргстекло
сантехнический: сантехнического
детейлинг: детейлинг
миграционный: миграционные
каменск: каменск
курган: курган
онколог: онколога
факторинг: факторинга
аппаратура: аппаратуры
мфц: мфц
операция: операции
бассейн: бассейны
постельный: постельные
интернет: интернете интернет интернета
обнаруживать: обнаружено
находка: находка
плитка: плитка
переговорный: переговорные
самый: самые
плые: плых
металлопрокат: металлопрокат
участковый: участковые
красить: красящие
фундамент: фундамента
нетканый: нетканые
ледовый: ледовые
тамбов: тамбов
кипиа: кипиа
обновляться: обновляются
отдых: отдыха отдых
бизнес: бизнеса бизнес
аудиотехника: аудиотехника
переработка: переработка переработки
лазерный: лазерная
выезд: выезде
мансийск: мансийск
бутафория: бутафория
владелец: владельцев
рг: рг
готовый: готового готовая готовых
визажист: визажиста
ташкент: ташкент
молочный: молочные
грузчик: грузчиков
архив: архивы
сбросить: сбросить
выгодный: выгодные
написать: напишите написать
бумага: бумаг бумага
спорт: спорта спорт
здоровье: здоровья здоровье
знак: знаки
парсинг: парсингу
студенческий: студенческие
надпись: надписи
прокат: прокат
автотранспорт: автотранспорта автотранспортом
парк: парки
цифровой: цифровая цифровой
каток: катки
караганда: караганда
атырау: атырау
комната: комнаты комнат
расходный: расходные
зернопереработка: зернопереработка
двигатель: двигателей двигателя
мороз: мороза
бронирование: бронирование
диетический: диетические
таможенный: таможенное
вода: воды вода
тату: тату
общественность: общественностью
игрушка: игрушки
хостел: хостелы
пакет: пакеты
новорожд: новорожд
калининград: калининград
проектирование: проектирование
альметьевск: альметьевск
прокуратура: прокуратура
приют: приюты
несколько: несколько нескольких
совершение: совершения
рыболовный: рыболовные
тагил: тагил
потолок: потолки
кавминводы: кавминводы
поселение: поселений
литейный: литейное
гимнастика: гимнастика
наградной: наградная
языковой: языковые
фельдшерский: фельдшерско
комбикорм: комбикорм
ценный: ценных
рубцовск: рубцовск
обработка: обработка
медиатор: медиаторов
ванна: ванн
загс: загсы
диспансер: диспансеры
агентство: агентства
школьный: школьная
корт: корты
системный: системного
табличка: табличек
исполнитель: исполнители
контрактный: контрактные
кабельный: кабельного
очищение: очищение
собор: соборы
нефтегазовый: нефтегазовое
замена: замена
слесарный: слесарно
автопаркинг: автопаркингов
трикотажный: трикотажных трикотажные
бюро: бюро
научно: научно
расч: расч
пищевой: пищевой пищевого
авиатранспорт: авиатранспорта
флексопечать: флексопечать
майкоп: майкоп
потребительский: потребительские
газ: газ газы
пермь: пермь
сервисный: сервисное
хозтовары: хозтовары
автостоянка: автостоянки
сахар: сахар
бензоинструмент: бензоинструмента бензоинструмент
дворец: дворцы
канатный: канатную
птица: птицы
университет: университеты
школа: школы
дезинфицирующий: дезинфицирующие
радиокомпания: радиокомпании
больница: больницы
отвечать: ответим
стеновый: стеновые
м: м
нягань: нягань
батутный: батутные
спасение: спасения
нотариальный: нотариальные
аудиторский: аудиторские
монастырь: монастыри
довольно: довольно
кондиционер: кондиционеры кондиционеров
реальный: реальный
пиццерия: пиццерии
йошкар: йошкар
видеооборудование: видеооборудование
автоцентр: автоцентры
нка: нка
вочный: вочные
чайный: чайные
пункт: пункты
вертебролог: вертебролога
нижний: нижний нижнее
линия: линий
норильск: норильск
резка: резка
яндекс: яндекс
подвеска: подвеска
техникум: техникумы
автоаксессуар: автоаксессуары
специалист: специалистов
формат: форматом формате
инфекционист: инфекциониста
беседка: беседок
ссылка: ссылку
топливный: топливные топливной
офтальмологический: офтальмологическая
домашние: домашние
знакомство: знакомств
профессия: профессиям
высотный: высотные
красноярск: красноярск
pr: pr
паровой: паровых
загар: загара
арбитражный: арбитражный
стадион: стадионы
вневедомственный: вневедомственная
избирательный: избирательные
зарядка: зарядки
некоторые: некоторые
заказывать: заказанную
ипотечный: ипотечное
клика: клике
дед: деда
смоленск: смоленск
это: это
час: часов
хабаровск: хабаровск
нож: ножи
мурманский: мурманская
екатеринбург: екатеринбурга екатеринбург
одесса: одесса
под: подъ
форма: форма формы
биотопливо: биотопливо
ишим: ишим
герой: герои
биотуалет: биотуалеты биотуалетов
купон: купонов
локальный: локальные
сплав: сплавы
рекрутинговый: рекрутинговые
избавление: избавлении
бишкек: бишкек
лдсп: лдсп
миасс: миасс
эзотерический: эзотерические
криогенный: криогенные
юр: юр
композиция: композиции
программа: программы
флеболог: флеболога
посуда: посуды посуда
сумка: сумки
отделочный: отделочные
известный: известными
цемент: цемент
коммутационный: коммутационное
новочеркасск: новочеркасск
иммунолог: иммунолога
кабина: кабин
аппаратный: аппаратная
чебоксары: чебоксары
маммолог: маммолога
федерация: федерации
безалкогольный: безалкогольные безалкогольных
зеркало: зеркала
животный: животных
железный: железных
мечеть: мечети
организм: организма
анадырь: анадырь
фигура: фигуры
стерлитамак: стерлитамак
клуб: клубы
новгород: новгород
кровь: крови
вещество: вещества
пресс: пресс
коммунальный: коммунальные коммунальными коммунальных
аквааэробика: аквааэробике
чердачный: чердачные
беременный: беременных
техника: техника техники
эпидемиологический: эпидемиологические эпидемиологический
ночной: ночные
спид: спидом
микрохирургия: микрохирургия
короткий: кратчайшие
тонировочный: тонировочные
томск: томск
касса: кассы
драгоценный: драгоценных
вибрация: вибрации
общий: общее общей
пластинка: пластинки
широкоформатный: широкоформатная
акушерский: акушерские
суд: судах суды судов
номерной: номерные
паломнический: паломнические
фреш: фреш
банкетный: банкетные
печь: печи
пиво: пиво пива
косметический: косметические
ведомственный: ведомственная
осмотр: осмотр
indoor: indoor
прощальный: прощальные
лизинговый: лизинговые
ателье: ателье
спам: спам
рыбинск: рыбинск
автоматизация: автоматизация автоматизации
бейдж: бейджей
храм: храмы
госпиталь: госпитали
аквапечати: аквапечати
автоэкспертиза: автоэкспертиза
сясьстрой: сясьстрой
объявление: объявлений
миграция: миграции
укладка: укладка
укрывной: укрывной
электронагревательный: электронагревательное
многопрофильный: многопрофильные
кардиолог: кардиолога
действовать: действуют
снэковой: снэковая
уролог: уролога
труд: труда
выхлопной: выхлопных
пластический: пластическая
автооборудование: автооборудование
саморегулируемый: саморегулируемые
асбестотехнический: асбестотехническая
протез: протезы
издание: изданий
политический: политические
рольставня: рольставни
сантехника: сантехника
мука: мука
физический: физических
дсп: дсп
маркетинговый: маркетинговые
процесс: процессов
ханты: ханты
офисный: офисная офисные
субъект: субъектов
посольство: посольства
химический: химическое
развлекательный: развлекательные развлекательное
условие: условий
актобе: актобе
исследование: исследования
барбершоп: барбершопы
мные: мные
зерно: зерно
набережная: набережные
праздничный: праздничного
web: web
дизайн: дизайн
металлообрабатывающий: металлообрабатывающее
коттедж: коттеджей
л: л
украина: украины
авточехол: авточехлов
владикавказ: владикавказ
фонтан: фонтанов
ветеринария: ветеринария
штрафстоянка: штрафстоянки
рекламный: рекламных рекламные
аллерголог: аллерголога
депо: депо
архитектура: архитектура
гипсокартон: гипсокартон
теплоизоляционный: теплоизоляционные
карбюратор: карбюраторов
казань: казани казань
спасательный: спасательное
откуда: откуда
попросту: попросту
абразивный: абразивный
овируг: овируг
ресница: ресницами
владивосток: владивосток
опт: опт
родильный: родильные
мвд: мвд
киностудия: киностудии
натяжной: натяжные
лабораторный: лабораторные
отфильтровывать: отфильтровать
спецпри: спецпри
идти: идет
атс: атс
медико: медико
ip: ip
музыкальный: музыкальные музыкальных
молла: моллы
жидкий: жидкими
тобольск: тобольск
хирургия: хирургия
жидкость: жидкости
автошкола: автошколы
канализация: канализации
продвижение: продвижение
нейрохирург: нейрохирурга
мониторинг: мониторинга
консульство: консульства
анализ: анализы
нефтепродукт: нефтепродукты
сооружение: сооружений сооружения
судовой: судовое судового
парковочный: парковочных
дайвинг: дайвинг
престарелый: престарелых
контейнер: контейнеры
выгребной: выгребных
окрасочный: окрасочное
бель: бель
зооботанический: зооботанический
автовокзал: автовокзалы
архивный: архивные
поликарбонат: поликарбонат
жалюзи: жалюзи
коллективный: коллективные
переоборудование: переоборудование
земляной: земляные
новостройка: новостройки
эпиляция: эпиляция
помещение: помещениях помещений
ключ: ключей
авиатехник: авиатехника
алмазный: алмазное
академия: академии
аэс: аэс
диск: диски дисков
компонент: компоненты
гидроизоляционный: гидроизоляционные
ставрополь: ставрополь
директ: директ
сразу: сразу
кокшетау: кокшетау
пляж: пляжи
альтернативный: альтернативной альтернативные
чита: чита
депутат: депутатов
экскурсия: экскурсий
смс: смс
салехард: салехард
рф: рф
мелкофасованный: мелкофасованные
комиссар: комиссаров
казахстан: казахстана
чрезвычайный: чрезвычайных
электропередача: электропередач
орган: органы
элемент: элементы
электротранспорт: электротранспорта
звуковой: звуковое
амбулатория: амбулатории
серийный: серийное
убор: уборы
бильярдная: бильярдные
ош: ош
актуальный: актуальную
шлифовка: шлифовка
аксессуар: аксессуары
металлорежущий: металлорежущий
вокзал: вокзалы
интерьер: интерьеров интерьера
карнавальный: карнавальные
агентирование: агентирование
склад: склада склады
книга: книги
такси: такси
отправлять: отправить
исправительный: исправительные
т: т
звукозапись: звукозаписи
библиотека: библиотеки
архитектурный: архитектурно
макаронный: макаронные
давать: дают
надувной: надувная надувные
досуг: досуг
биробиджан: биробиджан
ведение: ведение ведения
металлоизделие: металлоизделия
химчистка: химчисток химчистки
уровень: уровня
банкомат: банкоматы
навигационный: навигационное
горный: горно
мурманск: мурманск
современный: современный
ванный: ванных
тендер: тендеров
замок: замки замков
банкротство: банкротстве
колледж: колледжи
воскресный: воскресные
кумертау: кумертау
челябинск: челябинск
детская: детская
сюрвейерский: сюрвейерские
кондитерский: кондитерские кондитерский
массажный: массажное
комитет: комитет
дилинговый: дилинговые
инструктор: инструкторов
семья: семьи
дератизация: дератизация
улан: улан
волгодонск: волгодонск
ипподром: ипподромы
сотовый: сотовой
карниз: карнизы
человек: людей людям человека
выбор: выбор
нарушать: нарушаем
одноразовый: одноразовая
очередь: очередь
собирать: собрана
партия: партии
сро: сро
зарегистрировать: зарегистрирована
кадастровый: кадастровые
самоуправление: самоуправления
тактический: тактические
перьевой: перьевых
обувь: обувь обуви
туристический: туристические
нержавеющий: нержавеющий
квест: квестов
транспортный: транспортные
эндокринолог: эндокринолога
пиломатериал: пиломатериалы
определять: определить
кредит: кредита
ковер: ковров ковры
загрузка: загрузка
внутридомовый: внутридомового
павлодар: павлодар
гимназия: гимназии
правовой: правовые
пирсинг: пирсинга
земля: земли
го: го
когалым: когалым
пневмоинструмент: пневмоинструмент
радиоуправляемый: радиоуправляемые
братск: братск
мотоцентр: мотоцентры
предоставляться: предоставляется
фрахтование: фрахтование
ландшафтный: ландшафтная
праздник: праздников
энергия: энергии
блюдо: блюд
квалификация: квалификации
отправляться: отправляется
прямой: прямая
невинномысск: невинномысск
автоматически: автоматически
каменогорск: каменогорск
мусульманский: мусульманская
бийск: бийск
груз: грузов
фониатр: фониатра
гидрометеослужба: гидрометеослужба
обои: обои
фитнес: фитнес
фальшивка: фальшивка
иконописный: иконописные
ижевск: ижевск
махачкала: махачкала
консалтинг: консалтинг
фрезеровка: фрезеровки
врачебный: врачебной врачебные
полуфабрикат: полуфабрикаты
крупный: крупных
новогодний: новогодние
быстро: быстро
психиатрический: психиатрические
бассейнов: бассейнов
виза: виз
занятость: занятости
мастерство: мастерства
подарочный: подарочная подарочных
учет: учет
суша: суши
трихолог: трихолога
поиск: поиска
который: которое
проблема: проблемой проблема
амур: амуре
картридж: картриджей
народный: народных народного
радиосвязь: радиосвязи
охранный: охранно
петербург: петербург
прототипирование: прототипирование
фурнитура: фурнитура
либо: либо
блокировать: блокировать
фасадный: фасадные
радиационный: радиационный радиационного
весь: вся
секунда: секунд
благотворительный: благотворительные
проктолог: проктолога
сотрудничество: сотрудничеству
сомнолог: сомнолога
дополнительный: дополнительные
данные: данные
продюсирование: продюсирования
следственный: следственный
технология: технологии
оператор: операторы
пуховой: пуховые
черкесск: черкесск
вводить: вводите
хасавюрт: хасавюрт
автомасло: автомасла
конструкция: конструкции конструкций
носочный: носочные
аэрография: аэрография аэрографии
биометрический: биометрические
платеж: платежей
развал: развал
курск: курск
магнитогорск: магнитогорск
пл: пл
excel: excel
курение: курения
реабилитационный: реабилитационные
сувенирный: сувенирные
автостанция: автостанции
предложение: предложение
дезинсекция: дезинсекция
автозаправочный: автозаправочные
барнаул: барнаул
вскрытие: вскрытие
коллекторский: коллекторские
денежный: денежных
воздух: воздуха
ранний: раннего
собственность: собственности
заболевание: заболеваний
тахограф: тахографы
мультимедийный: мультимедийного
психологический: психологическая
пряность: пряности
фтизиатр: фтизиатра
закрывать: закрыть
видеостудия: видеостудии
объект: объектов
шум: шума
каждый: каждого
ортопедический: ортопедические
программный: программного
гаражный: гаражные
автобус: автобусов
дендрарий: дендрарий
мешок: мешке
зуботехнический: зуботехнические
ходовой: ходовой
маслопродукты: маслопродукты
процедурный: процедурного
радиоэлектронный: радиоэлектронные
эвакуация: эвакуация
саратов: саратов
ная: ная
центр: центры
липецк: липецк
тольятти: тольятти
резервуар: резервуары
мама: мам
подпись: подписей
сто: сто
профилакторий: профилактории
правый: прав
ароматовары: ароматовары
пухо: пухо
гис: гис
итого: итого
карьера: карьера
кузовной: кузовной
питомник: питомники
сборный: сборные
модельный: модельные
тентовый: тентовые
пломбировочный: пломбировочные
мануальный: мануальной
гомеопат: гомеопата
ботанический: ботанический
кабель: кабель
плата: плат
монтажный: монтажный
водоотведение: водоотведения
уголь: уголь
подростковый: подростковые
предпусковой: предпусковые
подарок: подарков
выкладывать: выложено
вера: вер
отогрев: отогреву
шахта: шахты
светопрозрачный: светопрозрачные
dvd: dvd
генетический: генетические
иркутск: иркутск
маркировка: маркировки
колбасный: колбасные
кредитование: кредитование
якутск: якутск
отдел: отделы
корма: корма
сертификация: сертификация
зоопарк: зоопарк
семинар: семинары
д: д
изолятор: изоляторы
вологда: вологда
кассовый: кассовая
киношкола: киношколы
шелкография: шелкография
двпо: двпо
продукт: продукты
время: время
парковый: парковая
электромонтажный: электромонтажные
квартирный: квартирные
мероприятие: мероприятия мероприятий
дисконтный: дисконтные
редуктор: редукторы
климатический: климатического климатических
канцелярия: канцелярия
мастер: мастеров
представительный: представительная
продаваться: продаются
овощ: овощи
пособие: пособий
будущий: будущих
вокал: вокала
видеос: видеосъ
иностранный: иностранных
нные: нных
вопрос: вопрос вопросам
карус: карус
тара: тара
спецмагазин: спецмагазины
электроинструмент: электроинструмента электроинструмент
переливание: переливания
кызыл: кызыл
клиника: клиники
витрина: витрины
гибдд: гибдд
мужской: мужская
потребление: потребления
астана: астана
стеклянный: стеклянная
реставрация: реставрация
частный: частные
теплоэнергосеть: теплоэнергосетей
массажист: массажиста массажистов
противопожарный: противопожарное
специальный: специальная
доверие: доверия
метод: методы
салют: салюты
цирковой: цирковые
ткань: ткани
площадка: площадок
пошив: пошив
нарьян: нарьян
изготовление: изготовление
тренаж: тренаж
комплекс: комплексы
отечественный: отечественных
профориентация: профориентации
гравировка: гравировки
отделка: отделка
таможня: таможня
столовый: столовые
казначейство: казначейства
резиновый: резиновые
адрес: адрес
электротехника: электротехника
спецодежда: спецодежда
ритуальный: ритуальные
автозапчасть: автозапчасти
челн: челны
автотовары: автотовары
детектор: детекторы
пристав: приставов
кулинарный: кулинарные
фото: фото
плавание: плавания
управленческий: управленческий
снаряжение: снаряжение
gi: gis
цветной: цветной
общежитие: общежития
распиловка: распиловки
гепатолог: гепатолога
подбор: подбор
csv: csv
кейтеринг: кейтеринг
ознакомление: ознакомления
код: код
скорый: скорая
волгоград: волгоград
секонд: секонд
театр: театры
кальян: кальяны
все: всем
рефлексотерапевт: рефлексотерапевта
магадан: магадан
республика: республика
акпп: акпп
фотокнига: фотокниг
армада: армада
электрический: электрические
смочь: сможете
мусор: мусора
разбираться: разберемся
предпечатный: предпечатная
банк: банки
деревообрабатывающий: деревообрабатывающий деревообрабатывающее
плоттерный: плоттерная
часто: часто
посадочный: посадочный
церковь: церкви
загранпаспорт: загранпаспортов
call: call
златоуст: златоуст
фотоцентр: фотоцентры
метрополитен: метрополитена
обязательно: обязательно
горнолыжный: горнолыжные
паевой: паевые
гидротехнический: гидротехническое
логопед: логопеда
производственный: производственных
соль: соль
размещение: размещение
справочник: справочники
членство: членства
открытка: открытки
кормить: кормящих
алматы: алматы
буквально: буквально
содержание: содержания
морг: морги
удобрение: удобрения
клининг: клининг
вторсырь: вторсырь
художественный: художественные
фотостудия: фотостудии
косметика: косметика
нефролог: нефролога
декорация: декорации
мороженое: мороженое
комплектующий: комплектующие
корпус: корпуса
интерьерный: интерьерные
кофе: кофе
фанера: фанера
лоджия: лоджий
зоотовары: зоотовары
нажимать: нажмите
дизайнерский: дизайнерские
оптический: оптические
энергоснабжение: энергоснабжение
