комфортный: комфортная
полезный: полезные
экспертный: экспертный
россия: россии
академик: академика
смс: смс
рф: рф
реабилитационный: реабилитационных
жизнь: жизни
возможность: возможностях
наб: наб
дело: делом
доказывать: доказанных
приобретение: приобретение приобретению
подробно: подробнее
e: e
трудоспособность: трудоспособность
помогать: помочь помогаем помогать помогли
подарить: подари
восстанавливать: восстанавливает
общество: обществе
слабовидящий: слабовидящих
это: это
адрес: адрес
благотворитель: благотворителям
недоношенный: недоношенным недоношенными
день: день
трудовой: трудовых
оказывать: оказываемой
mail: mail
цель: цели
рожать: рожденным
центр: центр центре
значительный: значительном
совет: совет
семейный: семейном семейный
эффективный: эффективных
pm: pm
волонт: волонт
плата: плат
регион: регионы
отчет: отчеты
premium: premium
направлять: направлен
offline: offline
одноклассник: одноклассники
год: годах
квалифицированный: квалифицированную
адаптивный: адаптивная
благотворительный: благотворительный
попечитель: попечители
уставный: уставные
theme: theme themes
бик: бик
monday: monday
страница: страница
наш: наши
контакт: контакты
окно: окне
youtube: youtube
сбор: сбор
фонд: фонде фонд фонда
т: т
программа: программ программы
отзыв: отзывы
поддерживать: поддерживают
создавать: создан
качество: качества
повышение: повышение
открываться: открывается
совершать: соверши
поступок: поступок
физический: физической физическая
friday: friday
сми: сми
подтвердить: подтвердите
sunlightfond: sunlightfond
малыш: малышей
поставлять: поставленной
уровень: уровня
ребенок: детей детьми детям
мобильный: мобильных
основной: основная
г: г
эфир: эфир
реквизит: реквизиты
организм: организма
текст: текстом
культура: культура
свет: свет
школа: школы школа
прямой: прямой
улучшение: улучшении
каба: каб
новость: новости
документ: документы
событие: события
д: д
truly: truly
версия: версия
рама: рам
минюст: минюст
самореализация: самореализации
солнечный: солнечный
необходимый: необходимую
рассылка: рассылку
пао: пао
проект: проект
научно: научно
счет: счет
доступность: доступности
медицинский: медицинскую
влиять: влияя
получать: получить
государственный: государственной
инн: инн
перезванивать: перезвоним
материал: материалы
задача: задачи
вконтакте: вконтакте
деятельность: деятельности
ранний: ранней раннем
регистрация: регистрации
системный: системных
география: география
поддержка: поддержку
методика: методика методик
ресурсный: ресурсный
описание: описание
самый: самых
сбербанк: сбербанк
жизнедеятельность: жизнедеятельности
нко: нко
отправлять: отправьте
содержание: содержанию
решение: решений
info: info
поиск: поиск поиске
туполева: туполева
р: р
online: online
помощь: помощи помощь
подписка: подписка
бф: бф
иды: ид
афк: афк
свидетельство: свидетельство
психологический: психологическую
навык: навыков
история: истории
восстановление: восстановления
wordpress: wordpress
сумма: сумма
дцп: дцп
номер: номер
вверх: вверх
профилактика: профилактики
срок: сроке
реестр: реестре
огрн: огрн
переходить: перейти
посол: послы
сотрудник: сотрудники
адаптация: адаптации
ru: ru
сво: сво
фокусировать: фокусируем
скоро: скоро
фотогалерея: фотогалерея
dream: dream
москва: москва
каждый: каждый
нные: нным
вязание: вязание
функция: функции
copyright: copyright
носочек: носочки
подготовленность: подготовленности
рожд: рожд
медиагалерея: медиагалерея
любой: любая
телефон: телефон
мероприятие: мероприятие
миссия: миссия
оператор: операторов
родитель: родителей
кпп: кпп
один: одна
окпо: окпо
развитие: развитие
внимание: внимание
новый: новом
команда: команда
семья: семьям
способствовать: способствующая
