твц: твц
нажимать: нажимая
следить: следите
смс: смс
бонус: бонусы
ваш: вашего вашим
билет: билет
украшение: украшений украшения
e: e
дата: даты
никакой: никакого
принимать: принимаете
вариант: вариант
эксклюзивность: эксклюзивность
участник: участникам участников участники
розыгрыш: розыгрыши розыгрышами
ноябрь: ноября
самостоятельно: самостоятельно
это: это
сайт: сайте
социальный: социальных
mail: mail
пустяк: пустякам
бижутерия: бижутерии бижутерия
экземпляр: экземпляре
фотография: фотографии
связь: связи
атмосфера: атмосфера
аккаунт: аккаунтах
год: году
красота: красоты
отправлять: отправим отправить
письмо: письма писем
часы: часы
пресса: прессе
показывать: показать
единственный: единственном
руб: руб
контакт: контакты
создавать: созданные создавать
т: т
желающий: желающих
фурнитура: фурнитура
sm: sms
товар: товаров
гарантировать: гарантируем
whatsapp: whatsapp
прошлый: прошлой
новый: новыми
обзор: обзорами
личный: личным
заявка: заявку
коктейль: коктейль
электронный: электронную электронного
получение: получения
спецпроект: спецпроекты
материал: материалов
модуль: модуль
партнер: партнерам
д: д
беспокоить: беспокоить
твк: твк
купить: купить
приятный: приятная
com: com
пресс: пресс
шарм: шарма
уникальный: уникальные
начало: начале
данный: данным
февраль: февраля
смочь: сможете
аренда: аренда
проведение: проведения
хороший: хорошее
любой: любой
добираться: добраться
авторский: авторские
головокружительный: головокружительный
маяковская: маяковская
удобство: удобства
наш: наших
спам: спама
удобный: удобный
всемирно: всемирно
выставка: выставками выставка выставки
ежедневный: ежедневные
отказываться: отказаться
мастер: мастеров
продажа: продажа
пл: пл
раритетный: раритетные
карта: карте
пользоваться: пользуемся
прямо: прямо
info: info
изыск: изыска
почитать: почту
относиться: относимся
м: м
информация: информации
рассылка: рассылок
наиболее: наиболее
moscow: moscow
кнопка: кнопку
архив: архив
техник: техник
пользовательский: пользовательского пользовательское
аксессуар: аксессуаров
напоминать: напомним напомнить
стиль: стилей
тишинка: тишинка
безопасно: безопасно
условие: условия
соглашение: соглашения соглашение
известный: известных
сеть: сетях
бережно: бережно
выбирать: выбирайте
сервис: сервисами
винтажный: винтажная
настроение: настроение
фотогалерея: фотогалерея
дарить: дарит
белорусский: белорусская
москва: москва
bijou: bijou
показ: показы
проект: проекте
тишинский: тишинская
проверенный: проверенными
релиз: релиз
подавать: подать
посетитель: посетителям
х: х
спонсор: спонсорам
модный: модные
быть: будем
хотеть: хотите
бренд: брендов
разнообразие: разнообразие
стенд: стенда
работа: работы
