смс: смс
поддерживать: поддержать поддерживаем
детский: детском детских
подробно: подробнее подробно
одиночка: одиночке
будущее: будущее
задумываться: задумываетесь
хотеть: хочу хотели
онлайн: онлайн
жить: живет жить
дом: домах дом доме
ребенок: ребенка детям детей дети ребенке
именно: именно
мы: нам нами
важно: важно
форум: форум
количество: количество
главный: главная
воспитывать: воспитывает
репетитор: репетиторами
отправлять: отправь отправить
работать: работаем
глобус: глобусе глобус
обрабатывать: обработать
семья: семьям семье семьи семей
зарегистрироваться: зарегистрироваться
наш: нашего наша нашей наш наши
уставный: уставную
волонтер: волонтерам волонтером волонтерами волонтеры волонтеров
фонд: фонде фонд фонда
перенаправлять: перенаправить
сторона: стороне
вербальный: вербальное
сложный: сложной
татьяна: татьяны
успевать: успевают
трое: троих
детдом: детдоме детдома
многие: многие
запрос: запросы
вводный: вводный
реквизит: реквизиты
особенность: особенностями
школа: школе школы школа
пропускать: пропустила
документ: документы
приходить: приходите пришла
роды: роды
трудный: трудной трудным
очень: очень
дистанционный: дистанционное
становиться: стать станет
помогать: помоги поможет помочь поможем помогай помогаем помогать
территория: территория
слепота: слепоты
оставаться: останутся
необходимый: необходим необходима
участник: участниками
польза: пользу
ментальный: ментальными
благодаря: благодаря
последний: последнего
финансовый: финансовые
акция: акцию акции акциям
планета: планету
раздача: раздачи
сирота: сиротам сирот
лекарство: лекарств
поведение: поведением поведение
социальный: социального
март: марта
изменение: изменениям
info: info
гипермаркет: гипермаркете гипермаркетах
искать: ищем
история: истории история
ясный: ясная
собирать: собрать
навредить: навредить
благотворительный: благотворительной благотворительный благотворительную
оплата: оплате оплатой
зрение: зрение зрению
спасать: спасти
хадишеть: хадишат
приглашать: приглашаем
нужный: нужны нужна
сделать: сделай
ребята: ребятам
соглашение: соглашение
каждый: каждый
мероприятие: мероприятиям
приобретать: приобрести
который: которых которую которые
расти: растет
принимать: принимать
реальный: реальным
миссия: миссия
родитель: родителей родителям
узнавать: узнать
квартира: квартира
второй: втором
подопечный: подопечных
волонтерский: волонтерской
связываться: связаться
родные: родные
otk: otk
приемная: приемной
таня: тане
будни: будни
причина: причина
навык: навыки
альшанский: альшанская
очищать: очищай
близкие: близкие
одинокий: одинокой
дочь: дочери
желающий: желающих
устройство: устройства устройство
депривация: депривации
делать: делаем
сиротство: сиротства
обучение: обучение
девочка: девочке девочку
больница: больницах
ресурсный: ресурсное
присоединяться: присоединяйся присоединяйтесь
текст: текстом
сиротский: сиротские
отч: отч
заниматься: занимается
влад: владу
состояние: состояния
мать: матери
занятие: занятий занятия
рядом: рядом
горячий: горячая
шаг: шагом шаг
свое: свое
избегать: избежать
друг: друзья
курс: курс
программа: программа программы программу
ru: ru
пожертвование: пожертвований
тысяча: тысяч
попадать: попадали
отказ: отказа отказов
вика: вике
просить: просим
специалист: специалистов
учреждение: учреждениях учреждения
особенно: особенно
партнер: партнеры
школьный: школьную
изменять: изменить
годовой: годовые
жертвователь: жертвователям
листовка: листовок
жизнь: жизни
подросток: подростка
отбирать: отбирают
ситуация: ситуации
зал: зале
семейный: семейное семейного
срочно: срочно
пусть: пусть
это: это
день: день
травля: травли
мные: мным
мама: мамы маме мамой
пожертвовать: пожертвовать
значит: значит
линия: линия
отчет: отчеты
год: года
некуда: некуда
событие: событие события
объявление: объявления
библиотека: библиотека
отказник: отказники
крышечка: крышечки
авторизация: авторизация
сопровождение: сопровождение
новость: новости
политика: политика
важный: важны
крыться: кроется
семинар: семинар семинары
ждать: ждем
пресс: пресс
нураид: нураиде
работа: работе
цель: цель
тяжелый: тяжелые
оплачивать: оплатить
регулярно: регулярно
забывать: забыли
музей: музей
информационный: информационный
поступление: поступления
кстати: кстати
профилактика: профилактика
образование: образование
пароль: пароль
мысль: мысли
деятельность: деятельность деятельности
помощь: помощи помощь
пробел: пробел
вопрос: вопросам
домашний: домашнее
сумма: сумма
близко: близко
номер: номер
ухудшение: ухудшения
постоянный: постоянные
вакансия: вакансии
кризис: кризиса
система: систему
печально: печально
замещать: замещающих
добрый: добрые
беда: беде
продолжать: продолжить
курсы: курсы
насилие: насилие
оказываться: оказались
виктория: виктории
новый: новые
команда: команда
обеспечение: обеспечение
тепло: теплом
реабилитация: реабилитации
влиять: влияет
операция: операцию
взрослый: взрослого
полный: полной
новорожденный: новорожденных
контакт: контакты
передавать: передать
смотреть: смотреть
человек: люди
рассказ: рассказ
основной: основная
рубль: рублей
прошлое: прошлом
менять: меняют менять
обращение: обращений
февраль: февраля
одиннадцатый: одиннадцатый
проект: проект
большой: большим
сбор: сбору
поддержка: поддержки
регистрация: регистрации
маленький: маленький
позволять: позволят
мир: мир
специальный: специальной
приемный: приемных
подписываться: подписаться
жизненный: жизненной
проходить: проходить
свидетельство: свидетельство
сенсорный: сенсорном
конфиденциальность: конфиденциальности
теплый: теплый
полтора: полтора
нужно: нужно
проблема: проблема
пользовательский: пользовательское
москва: москва москвы
сотрудник: сотрудники
создавать: создай
щелково: щелково
otkazniki: otkazniki
опыт: опытом
приносить: принести
нагонять: нагнать
грань: грани
один: одна
центр: центр
вебинар: вебинар
владик: владику
елена: елена
покупка: покупкой
