компрессор: компрессоры
бетонолом: бетоноломы
бункеровоз: бункеровозы
рф: рф
ямочный: ямочного
caterpillar: caterpillar
гидравлический: гидравлические
кассетный: кассетные
англия: англии
онлайн: онлайн
монтажный: монтажные
приставной: приставные
жкх: жкх
содержать: содержит
регенерация: регенерацией
погрузчик: погрузчики погрузчик
копровой: копровые
навесной: навесные навесной навесное
интерес: интересах
фреза: фрезы фреза
транспортный: транспортной
э: э
ульяновск: ульяновск
галичанин: галичанин
мчс: мчс
планировщик: планировщики
расположение: расположения
дробилка: дробилки
место: место
мачта: мачты
самара: самара
насос: насосы
мачтовой: мачтовые
главный: главная
бензиновый: бензиновые
асфальтоукладчик: асфальтоукладчики
многочелюстной: многочелюстные
область: область
шестеренный: шестеренные
полуприцеп: полуприцеп полуприцепы полуприцепов
опалубка: опалубка
строительный: строительной строительными строительно строительные строительного строительная строительное
т: т
швейцария: швейцарии
дизель: дизель
самоходный: самоходные
гидроножницы: гидроножницы
новый: новых новой новый новая
кран: краны кран
коммунальный: коммунальное коммунальными коммунальная коммунальной
какой: каком
нарезчик: нарезчики
вибратор: вибраторы
характеристика: характеристики
короткобазовый: короткобазовые
навесный: навесного
система: систем система
многопустотный: многопустотных
бункер: бункеры
новое: новое
вахтовый: вахтовые
электробур: электробуры
официальный: официальный
техника: технике технику техника техники
очистка: очистки
включать: включающий включает
элеватор: элеваторы
лифт: лифт лифты
позволять: позволяет
публикация: публикации
пищевой: пищевые
асфальтобетонный: асфальтобетонные
сша: сша
вездеход: вездеходы
рейтинг: рейтинг
австрия: австрии
бадья: бадьи
грузовой: грузовой грузовые грузовая грузовых
битумовоз: битумовозы
битумощебнераспределитель: битумощебнераспределители
рамный: рамные
цемент: цемента
подача: подачи
драглайн: драглайны
ассенизаторский: ассенизаторские
отход: отходов
марк: марку
панель: панелей
технический: техническая технические
машиностроительный: машиностроительный машиностроительные машиностроительная
штабелер: штабелеры
дорожный: дорожной дорожного дорожно дорожный дорожными дорожная дорожные дорожное
раздвижной: раздвижные
снегопогрузчик: снегопогрузчики
применение: применением
комплектующий: комплектующих
гнб: гнб
прицепной: прицепного прицепные
пеноподъемник: пеноподъемники
co: co
трубчатый: трубчатые
каталог: каталог каталога каталоге
пневмоколесный: пневмоколесные
манипулятор: манипулятор манипуляторы
пассажирский: пассажирские
ножничный: ножничные
автогидроподъемник: автогидроподъемники
тракторный: тракторного
справочник: справочник
выпускать: выпускать
машиностроение: машиностроения машиностроение
аксиально: аксиально
колонна: колонн
португалия: португалии
спецтехника: спецтехника спецтехнике спецтехники
турция: турции
польша: польши
крюковой: крюковой
трактор: тракторов тракторы
пожарный: пожарной пожарно пожарные пожарная
автолестница: автолестницы
изготовитель: изготовители изготовителя
линейка: линейка
земснаряд: земснаряды
вакуумный: вакуумные
снегоуборщик: снегоуборщики
бетонный: бетонные
оао: оао
словения: словении
бурый: буром
тюмень: тюмень
представлять: представленных
соглашение: соглашение
резчик: резчики
грейфер: грейферы грейфер
автопогрузчик: автопогрузчики
греция: греции
крупный: крупный крупнейшие
ходоуменьшитель: ходоуменьшители
страна: страна стран
интеллект: интеллекта
низкорамный: низкорамные
запчасть: запчасти запчастей
обзор: обзоры обзор
бревно: бревен
каток: катки
ру: ру
происхождение: происхождения
виброплита: виброплиты
кму: кму
асфальтосмесительный: асфальтосмесительные
бетонораспределительный: бетонораспределительные
чехия: чехии
ремонтный: ремонтные
россия: россии россия
подъем: подъема
вода: воды
кусторез: кусторезы
свайный: свайная
ковшовый: ковшовые
центробежный: центробежные
автогрейдер: автогрейдеры автогрейдер
отбор: отбора
включая: включая
гусеничный: гусеничном гусеничные гусеничный
уплотнитель: уплотнители
ф: ф
сваебойный: сваебойные
телескопический: телескопические
автовышка: автовышки
перегружатель: перегружатели
автоцистерна: автоцистерны
площадка: площадки
пересадка: пересадки
штанговый: штанговые
италия: италии
трансмиссия: трансмиссии
испания: испании
автомобильный: автомобильные автомобильных автомобильный автомобильном
апх: апх
привышечный: привышечных
эмульсия: эмульсий
шлифовальный: шлифовальные
использовать: используемые
малогабаритный: малогабаритные
подмости: подмости
завершать: завершить
гидроруль: гидрорули
автобетоносмеситель: автобетоносмесители
оборудование: оборудование оборудования оборудовании
установка: установки
роторный: роторные роторная
снегоболотоход: снегоболотоходы
двигатель: двигатели
компания: компаний компаниями компания
гидроцилиндр: гидроцилиндров гидроцилиндры
мотобура: мотобуры
угличский: угличский
гидрофреза: гидрофрезы
высокий: высокого
бурение: бурения
петербург: петербург
щековый: щековые
информация: информацию информации
черногория: черногории
вибротрамбовка: вибротрамбовки
фасадный: фасадные
автогудронатор: автогудронаторы
газонокосилка: газонокосилки
г: г
передвижной: передвижные
кс: кс
корпорация: корпорация
люлька: люльки люлькой
производитель: производителей производителях производитель производители производителя
разработка: разработка
ростсельмаша: ростсельмаш
сортовой: сортовые
данные: данные
вид: виды видов виде
топливозаправщик: топливозаправщики
фронтальный: фронтальные
технология: технологии
пао: пао
продукция: продукция продукции
др: др
асфальтовый: асфальтовые
бензовоз: бензовозы
производство: производства
устройство: устройства
автобетононасос: автобетононасосы
автобитумовоз: автобитумовозы
санкт: санкт
зарубежный: зарубежные зарубежных
ход: ходу
стрела: стрелой стрелы
пермь: пермь
болгария: болгарии
стройматериал: стройматериалов
минипогрузчик: минипогрузчики
контейнеровоз: контейнеровозы
жби: жби
сортировочный: сортировочные
дисковый: дисковый
давление: давления
автопоезд: автопоезда
пенобетон: пенобетона
молотковый: молотковые
кб: кб
тс: тс
мотокос: мотокосы
список: списка
завод: заводы заводов завода завод
машина: машины машин машина
стройоборудование: стройоборудование
промышленный: промышленном
дания: дании
тула: тула
начинать: начал
ломовоз: ломовозы
автомобиль: автомобили автомобилей
лес: леса
минск: минск
рынок: рынке рынка
силос: силосы
usa: usa
м: м
транспортировочный: транспортировочная
румыния: румынии
хомутовый: хомутовые
минисамосвал: минисамосвалы
насосный: насосные
также: также
мусорный: мусорные
новосибирск: новосибирск
туймазинский: туймазинский
стационарный: стационарные
урало: урало
российский: российского российские
заливщик: заливщики
фгуп: фгуп
грейдер: грейдеры
ножницы: ножницы
краснокамский: краснокамский
виброрейка: виброрейки
ru: ru
кабелеукладчик: кабелеукладчики
молот: молоты
полноприводный: полноприводные
история: история
мойка: мойки
мультилифт: мультилифт
швонарезчик: швонарезчики
уфа: уфа
камнеобрабатывающий: камнеобрабатывающее
шов: швов
снг: снг
строительство: строительство
ооо: ооо
челябинец: челябинец
каждый: каждого каждой
задний: задней
самозагружаемый: самозагружаемые
балковоз: балковозы
мусоровоз: мусоровозы
разметочный: разметочные
телефон: телефон
поршневой: поршневые
вибропогружатель: вибропогружатели
пескоразбрасыватель: пескоразбрасыватели
керамзит: керамзита
колесный: колесные
скрепер: скреперы
металлоформа: металлоформы
ульяновский: ульяновский
ремонт: ремонта
планировать: планирует
саратов: саратов
искусственный: искусственного
швеция: швеции
мир: мире
контейнерный: контейнерные
прицеп: прицепы прицепов
грузопассажирский: грузопассажирские
бетоносмеситель: бетоносмесители
отрезной: отрезные
ручной: ручные
диэлектрический: диэлектрические
затирочный: затирочные
гравитационный: гравитационные
тур: туры
фрезерный: фрезерные
работа: работ
гидромотор: гидромоторы
ресайклера: ресайклеры
мозаичный: мозаично
уборочный: уборочные
косилка: косилки
конусный: конусные
екатеринбург: екатеринбург
тягач: тягачи
клиновый: клиновые
козловый: козловые
гидронасос: гидронасосы
сайт: сайт сайте
год: году
платформа: платформы
траншеекопатель: траншеекопатель
дизельный: дизельные
линия: линия
грузоподъемность: грузоподъемностью
мультикар: мультикары
аэродромный: аэродромные
сортиментовоз: сортиментовозы
бетон: бетона
industry: industry
копер: копров
ветка: веток
сепаратор: сепараторы
шпала: шпал
рмз: рмз
форма: форма
сэндвич: сэндвич
указывать: указан указаны
гидробур: гидробуры
ленточный: ленточные
автобус: автобусы
стена: стен
ямобура: ямобуры
кантователь: кантователи
миниэкскаватор: миниэкскаваторы
коробка: коробки
измельчитель: измельчители
основной: основные
прямой: прямой
вышка: вышки
сочленять: сочлененные
ленточнопильный: ленточнопильные
барабан: барабаны
новость: новости
д: д
новгород: новгород
тяжелый: тяжелой
франция: франции
прибор: приборы
бульдозер: бульдозеры бульдозер
шарнирный: шарнирные
гидрооборудование: гидрооборудование
тонар: тонар
цепной: цепные
кредо: кредо
уплотнение: уплотнения
питатель: питатели
планетарный: планетарные
илосос: илососы
штурман: штурман
подметальный: подметально
захват: захват
интернет: интернете
cdminfo: cdminfo
табличный: табличная
выставка: выставки
усптк: усптк
киров: киров
демонтажный: демонтажных
sany: sany
спасательный: спасательной
китай: китай китая
volvo: volvo
самосвал: самосвалов самосвалы
великобритания: великобритании
бортовой: бортовые
мобильный: мобильные
контроль: контроля
радиально: радиально
уралвагонзавод: уралвагонзавод
растворонасос: растворонасосы
автобензовоз: автобензовозы
боковой: боковой
рукав: рукава
поворотный: поворотной поворотные
башенный: башенные
щебнераспределитель: щебнераспределители
гидростатический: гидростатические
лом: лома
транспорт: транспорте
гвоздильный: гвоздильные
двухроторный: двухроторные
норвегия: норвегии
тандемный: тандемные
вертикальный: вертикальные
электропогрузчик: электропогрузчики
пень: пней
телемакс: телемакс
нужный: нужную
автоспецтехника: автоспецтехника
плита: плит
блокчейн: блокчейн
автогазовоз: автогазовозы
комбинированный: комбинированные
анкета: анкеты
гидромолот: гидромолоты
автотопливозаправщик: автотопливозаправщики
реверсивный: реверсивные
уралмаш: уралмаш
гидрораспределитель: гидрораспределители
ковш: ковши
каналопромывочный: каналопромывочные
флагманский: флагманский
лестница: лестницы
выбирать: выбрать
трубовоз: трубовозы
виброкаток: виброкатки
траншейный: траншейные
аварийный: аварийно
двухвальный: двухвальные
комплекс: комплексы
лебедка: лебедок
снегоочиститель: снегоочистители
дробильный: дробильно
регулировать: регулируемые
труд: труда
тяжеловоз: тяжеловозы
поливомоечный: поливомоечные
опорный: опорно
железобетонный: железобетонных
автомат: автоматы
автокран: автокраны автокран
мостовая: мостовые
крановый: крановые
коленчатый: коленчатые
экскаватор: экскаваторы экскаватор
трубоукладчик: трубоукладчики
соединять: соединенных
адрес: адрес
мощность: мощности
правильно: правильно
дерево: деревьев
контейнер: контейнеры контейнеров
крмз: крмз
автобетоновоз: автобетоновозов
фото: фото
станция: станции
pm: pm
отечественный: отечественные
универсальный: универсальные универсальная
грейферный: грейферный грейферные
неразрушающий: неразрушающего
бельгия: бельгии
модель: моделях моделей
контакт: контакты
консольный: консольные
штыревой: штыревые
бетоноукладчик: бетоноукладчики
сушильный: сушильные
глубинный: глубинные
сдминфо: сдминфо
шасси: шасси
золотниковый: золотниковые
нижний: нижний
товар: товара
эвакуатор: эвакуаторы
горизонтальный: горизонтального
шагать: шагающие
камский: камский
загрузка: загрузкой
опубликовывать: опубликованы
лесовоз: лесовозы
конвейер: конвейеры
рязань: рязань
растворосмеситель: растворосмесители
газ: газов
ярославль: ярославль
электрический: электрические
мини: мини
казань: казань
механический: механический механические
мусор: мусора
автосамосвал: автосамосвалы
кузов: кузова
перекрытие: перекрытий
роспуск: роспуски
электростанция: электростанции
грунтовой: грунтовые
бетононасос: бетононасосы
размольный: размольное
лопата: лопатой
тонна: тонн
научный: научные
четырехосный: четырехосный
статья: статьи
подъемник: подъемники
фильтр: фильтры
тросовый: тросовый
вагоноопрокидыватель: вагоноопрокидыватели
бетоносмесительный: бетоносмесительные
принудительный: принудительные
дзержинский: дзержинского
сибирский: сибирская
специальный: специальной
станок: станки
седельный: седельные
грохот: грохоты
газозаправщик: газозаправщики
мазутовоз: мазутовозы
битумный: битумных
переносной: переносные
словакия: словакии
копать: копающий
карьерный: карьерные
цементовоз: цементовозы
камаз: камаз
воронеж: воронеж
америка: америки
финляндия: финляндии
бурильный: бурильно
москва: москва
штукатурный: штукатурные
вещь: вещей
штат: штатах
тротуарный: тротуарные
вилочный: вилочные
ltd: ltd
панелевоз: панелевозы
древесный: древесных
спецкран: спецкранов
смж: смж
урал: урал
германия: германии
развитие: развитие
марка: марки
раздел: раздел
наверх: наверх
нерегулируемый: нерегулируемые
площадочный: площадочные
heavy: heavy
буровой: буровые
