нажимать: нажимая
пользователь: пользователи пользователям
почтовый: почтовом
известный: известный
заканчиваться: закончилась
прощать: простите
хостинг: хостинг
материал: материал материалов материалы
itglobal: itglobal
узнавать: узнали
книга: книги
думать: думают
отправлять: отправить
ускорять: ускорить
шрифт: шрифты
смит: смит
устаревать: устарели устаревшей
верификация: верификацию
вчера: вчера
продолжать: продолжаем
дислексик: дислексиков
запрос: запросы
президент: президент
система: систему систем системой
движение: движения
позволять: позволяет
реклама: реклама
криптоактив: криптоактивами
банк: банков
владеть: владеющих
сша: сша
такой: такое такие
rpg: rpg
важный: важные важен
проходить: пройти
человек: люди человеком человека
задача: задач
delivery: delivery
налаживать: наладить
объяснять: объясняет
интернет: интернет
сеть: сеть сети
самый: самые самый самых
способствовать: способствует
бот: боты
цикл: цикла цикл
доступный: доступнее доступна
история: истории историю
тенденция: тенденций
цитирование: цитировании
заниматься: занимался
похожий: похожих
млрд: млрд
ия: ии
blue: blue
читать: читать
бизнес: бизнесу бизнеса
email: email
сегодня: сегодня
должный: должен
смочь: смогут сможет
удерживаться: удержались
размышлять: размышляет
нужный: нужен нужны нужна
vstack: vstack
видеокамера: видеокамеры
доля: доле
принимать: принимать
обзор: обзоры
ваш: ваше ваш вашу
который: которую которые который
рассказывать: рассказывать рассказываем рассказывает
компьютерра: компьютерру компьютерре компьютерры компьютерра
машинный: машинное машинного
двухфакторный: двухфакторная
близкий: ближайшем
прославляться: прославился
закинуть: закинуть
советовать: советуют
клиент: клиентам
запускать: запускать
новый: новый
twitter: twitter
связь: связи
алгоритм: алгоритмы
network: network
текст: текст
знать: знать
компания: компаний
старый: старая
отношение: отношениях
анонсировать: анонсировала
законодательство: законодательство
любой: любых
обучение: обучение обучения
гибкость: гибкость
сенсор: сенсоры
дополнительный: дополнительные
человеческий: человеческой
полезно: полезно
прогноз: прогноза
технология: технологии технологиях
кто: кому
сталкиваться: сталкиваются
ai: ai
рабочий: рабочем рабочие
хакер: хакер
оставлять: оставить
практика: практика
предлагать: предлагают
год: год лет
динамический: динамического
covid: covid
брэд: брэд
помогать: помогают
жизнь: жизни жизнь
сон: сна
развлечение: развлечения
тот: тех
терабайт: терабайты
информация: информации
облако: облака облако
расширять: расширяет
кнопка: кнопку
activision: activision
облачный: облачных
современный: современных современному
кевин: кевина кевин
переходить: перейти
процесс: процессы
линия: линий
платный: платную
content: content
сайт: сайта сайты
microsoft: microsoft
сей: сих
телефон: телефон
bard: bard
разбираться: разбираемся
специалист: специалистов
защита: защиты
мир: мир мире
foundry: foundry
аватар: аватаров
запуск: запуском
blizzard: blizzard
микроконтроллер: микроконтроллеры
сервис: сервисов
аналог: аналог
игра: игру игр
собственный: собственные
это: это
baidu: baidu
пересматривать: пересмотрит
обязательный: обязательна
легендарный: легендарный
ссылка: ссылка
плохой: плохие
призывать: призывает
митник: митник митника
счастливый: счастливыми
экзистенциальный: экзистенциальные
openai: openai
вычисление: вычисления
подозревать: подозреваете
туманный: туманные
gartner: gartner
мы: нам
заявка: заявку
новость: новостей новости
политика: политики политика
bigdata: bigdata
drg: drg
время: время
аутентификация: аутентификация
com: com
хороший: хорошее
продукт: продукт
цифровой: цифровые
датчик: датчики
собирать: собирают
тайна: тайны
поговорить: поговорим
соглашаться: соглашаетесь
сфера: сфере
архив: архив
покупка: покупка
считать: считают
эпоха: эпоха
попадать: попал
ждать: ждать
любовь: любовь
модель: модель модели
google: google
кризис: кризиса
time: time
менять: меняет
ита: ит
трекер: трекеры
использовать: использовать
контент: контента
суд: суд
гаджет: гаджеты
развитие: развитию
яркий: ярких
хайп: хайпа
инструмент: инструмент
чат: чат
автоматизация: автоматизации
партнерский: партнерскую партнерский
cdn: cdn
управление: управления
задавать: задавать
вопрос: вопросы
тренд: тренды трендов
ящик: ящике
блог: блоги
chatgpt: chatgpt
влиять: влияет
являться: является
инвестировать: инвестирует
первый: первый
искусственный: искусственный
мощный: мощный
место: месте
условие: условиями
интеллект: интеллект
привычка: привычек привычкой
проверять: проверял
какой: каким какие
непросто: непросто
web: web
vk: vk
конкуренция: конкуренции
инфраструктура: инфраструктуру
смысл: смысле
обложка: обложку
ес: ес
bing: bing
версия: версия
подписываться: подписаться подпишитесь
рассылка: рассылку
доставка: доставки
февраль: февраля
робот: роботам
журнал: журнал
невероятно: невероятно
пора: пор
будущее: будущем
доказывать: доказать
смиряться: смириться
голосовой: голосовые
статья: статьи
свой: своей
смертность: смертностью
бумажный: бумажная
роботизация: роботизация
необходимость: необходимостью
температура: температуры
конфиденциальность: конфиденциальности
использование: использовании
риск: рисками
лента: лента
устраивать: устроена
писать: писал
нужно: нужно
пять: пять
правило: правил
главный: главной
почему: почему
нейросеть: нейросеть
имя: имя
сделать: сделать
сложный: сложных
чтение: чтение
название: названием
захватить: захватят
разработчик: разработчиков
facebook: facebook
разработка: разработку
работать: работать
три: трех
instagram: instagram
