love: love
ваш: вашего вашему
рф: рф
mercure: mercure
истра: истра
сауна: сауны
samsung: samsung
цена: цене ценам
онлайн: онлайн
распространять: распространенных
компания: компании компаниями компания
чайка: чайка
серпухов: серпухов
включать: включено
подписка: подписку
низкий: низким
ребенок: детей дети детьми
ульяновск: ульяновск
бар: баре бара
египет: египет
мы: нами
смочь: сможем
affonykate: affonykate
бытовой: бытовая бытовую
композиция: композиция
железнодорожный: железнодорожный
хостинг: хостинг
близкий: ближайшие
массаж: массаж массажи
дон: дону
проживание: проживание
самара: самара
гораздо: гораздо
аксессуар: аксессуары
новороссийск: новороссийск
одежда: одежда одежду
гинекология: гинекология
берег: берегу
крым: крым
книга: книги
км: км
гостиница: гостиниц гостинице
ужин: ужины
долгопрудный: долгопрудный
мой: мои
milano: milano
область: область
приобретать: приобретать
видео: видео
наш: наши нашей
вернуться: вернется
псков: псков
нальчик: нальчик
япошить: япоша
костромской: костромская
речной: речными речной
новый: новые новая
ноутбук: ноутбуки
ремонт: ремонт
поддержка: поддержка
новское: новское
скачать: скачать
коррекция: коррекция
хороший: лучшие
регион: регионов
карибия: карибия
ресторан: рестораны ресторанах ресторана ресторане
партнер: партнерам партнерами
arthur: arthurs
чистка: чистка
отдыхать: отдохнуть
skysmart: skysmart
восприниматься: воспринимаются
бутик: бутик
приятно: приятно
челябинск: челябинск
cozy: cozy
biglion: biglion
углич: углич
фэнтази: фэнтази
бассейн: бассейна
творчество: творчества
семья: семьи
redoute: redoute
плаза: плаза
румик: румиком
проходить: пройти
украшение: украшения
ш: ш
стоп: стоп
выбор: выбор
прогулка: прогулками прогулки
софт: софт
тур: тура туры
зимний: зимние
купон: купонам купон купоны купонами купонов купону
алтай: алтай
booking: booking
магазин: магазинах магазины магазинов
март: марта
таиланд: таиланде таиланд
аквапарк: аквапарка аквапарке
ореховый: орехово
рио: рио
абхазия: абхазия
страхование: страхование
обувь: обувь
republic: republic
petshop: petshop
интернет: интернет
мобильный: мобильное мобильного мобильная мобильные
окунаться: окунитесь
скидка: скидок скидку скидка скидками скидки
avon: avon
ростов: ростов
реутов: реутов
турция: турция турции
тамбов: тамбов
приложение: приложение приложения
фрязино: фрязино
отдых: отдыха отдых
grand: grand
balance: balance
лазертаг: лазертаг
бизнес: бизнеса
лазерный: лазерная
тир: тиры
email: email
известный: известных
снегоход: снегоходе
час: часа
западный: западная
зуб: зуба
планшет: планшеты
получать: получать
удобный: удобные удобного удобный
посад: посад
kiko: kiko
бауманский: бауманская
камневед: камневеды
кошелек: кошельку
бренд: брендов бренды
компьютер: компьютеры
кэшбэк: кэшбэк кэшбэком
экономия: экономии
друг: друзей друга друзьями
соглашение: соглашение
карелия: карелия
пятигорск: пятигорск
отель: отели отель отелей отеле
vr: vr
каждый: каждый
абонемент: абонементы
красногорск: красногорск
весь: весь всей
альфа: альфа
греция: греции
la: la
холодильник: холодильник
здоровье: здоровье
профессия: профессий
акция: акции акциям акций
кикино: кикино
популярный: популярных популярные
шугаринг: шугаринг
улица: улица
бутырский: бутырская
помощь: помощью
ру: ру
бесплатно: бесплатно
внимание: внимание
aviasales: aviasales
юго: юго
покупка: покупках покупке покупок
связываться: связаться
фитнес: фитнес
бронирование: бронирование бронирования
россия: россии россия
цветок: цветы
доступный: доступны
здравсити: здравсити
посиделки: посиделки
достигать: достигает
дер: дер
игра: игры
ижевск: ижевск
калининград: калининград
тд: тд
подключаться: подключиться подключитесь
подмосковье: подмосковье
leomax: leomax
park: park
йога: йога
домодедово: домодедово
орбита: орбита
железный: железного
ферма: фермы
стелька: стелек
spa: spa
randewoo: randewoo
океанариум: океанариума
размер: размер
испания: испании
питание: питания питанием
приближать: приблизит
askona: askona
педикюр: педикюр
центр: центра центре центры
мебель: мебель
солнечногорск: солнечногорск
красота: красоты красота
возвращение: возвращение
руб: руб
обработка: обработка
фотосессия: фотосессии
кострома: кострома
отзыв: отзывы
поляна: поляна
предложение: предложения
петербург: петербург
сотня: сотни
салон: салона салонах
qr: qr
подтвердить: подтвердите
техника: технику техника
данный: данных
товар: товаров товары
потратить: потраченных
letique: letique
другой: другие другое других
г: г
обучение: обучение
телефон: телефоны телефон
сушишоп: сушишоп
удобно: удобно удобнее
доставка: доставка
тюльпан: тюльпанов
кухня: кухни
медицинский: медицинского
средство: средств
купить: куплено купить
поэтому: поэтому
химки: химки
home: home
клубничный: клубничный
маникюр: маникюр
продукция: продукция
play: play
санкт: санкт
майкоп: майкоп
электроника: электронику электроника
тульский: тульская
персональный: персональных персональной
пермь: пермь
оренбург: оренбург
франчайзинг: франчайзинг
детский: детскую детские
шар: шары
юг: юг
рядом: рядом
торговый: торговом
развлечение: развлечения
вс: вс
yves: yves
тула: тула
м: м
отправлять: отправили отправлять
батутный: батутные
stom: stom
сбермегамаркет: сбермегамаркет
вела: веле
букет: букет
подольск: подольск
экономить: экономить
также: также
партнерский: партнерская
новосибирск: новосибирск
cotosen: cotosen
защитник: защитник
йошкар: йошкар
globus: globus
банкет: банкеты
восковой: восковая
ответ: ответы
язык: языки
залесский: залесский
переходить: перейти
сухофрукты: сухофруктов
картинг: картинг
архангельск: архангельск
организовывать: организовывать
ru: ru
киберспорт: киберспорт
заправка: заправка
система: системе
красносельский: красносельская
меню: меню
астро: астро
уход: уход
закрывать: закрыть
путешествие: путешествия
сайт: сайта
уфа: уфа
яндекс: яндекс
адрес: адреса адрес
легко: легко
версия: версия версию
чехов: чеховъ
ортопедический: ортопедических ортопедические
полный: полную
балашиха: балашиха
delore: delore
mi: mi
специалист: специалисты
кидбург: кидбург
услуга: услуги услуг услугами
ювелирный: ювелирные
человек: людьми
socolor: socolor
тонировка: тонировка
фотообложка: фотообложке
оферта: оферта
анапа: анапа
кемерово: кемерово
липецк: липецк
красноярск: красноярск
профильный: профильные
ангстрем: ангстрем
автошкола: автошкола
кольцо: кольцо
сходить: сходить
клиника: клинике клиниках
альстромерие: альстромерий
приобретение: приобретение
ск: ск
kvadrmoto: kvadrmoto
участие: участие
обследование: обследование
вокзал: вокзал
смоленск: смоленск
посещение: посещении посещение посещением
гербера: гербер
rocher: rocher
загородный: загородного загородном
екатеринбург: екатеринбург
заем: займы
день: день
aliexpress: aliexpress
байкал: байкал
программа: программа программе
наслаждаться: насладиться
сибирь: сибирь
подтверждение: подтверждением
пос: пос
вднх: вднх
сеть: сети
одноклассник: одноклассники
кариес: кариеса
sale: sale
промокод: промокоды промокод
посмотреть: посмотреть
феодосий: феодосия
kidzania: kidzania
матрас: матрасы
написать: написать
местоположение: местоположению
иркутск: иркутск
романтический: романтический романтические
воздушный: воздушные
аппаратный: аппаратная
еда: еды еда
спорт: спорт
чебоксары: чебоксары
whatsapp: whatsapp
танк: танки
фигура: фигуры
лыткино: лыткино
адлер: адлер
зоомагазин: зоомагазины
одинцово: одинцово
клуб: клубе клубы
котельник: котельники
страна: странах страны страну
скидочный: скидочный
сумма: суммы
д: д
новгород: новгород
урология: урология
вологда: вологда
мрт: мрт
напиток: напитки
раков: раков
пользоваться: пользуется пользоваться
лечение: лечение
разовый: разовым
зрение: зрения
com: com
выходной: выходные
продукт: продукты
вред: вреда
появляться: появляются
zelenokart: zelenokart
сад: сада
отечество: отечества
воентанктура: воентанктур
секретный: секретные
минский: минского
диагностика: диагностика
конный: конные конными
печать: печать
новослободский: новослободская
hotel: hotel
экскурсия: экскурсии
избранный: избранное
вконтакте: вконтакте
выставка: выставки
разрабатывать: разработали
киров: киров
отсканировать: отсканируйте
бульвар: бульвар
часто: чаще
пушкино: пушкино
давно: давно
образование: образование
terapia: terapia
владимир: владимир
томск: томск
online: online
кредит: кредиты
ряд: ряд
foresta: foresta
безлимитный: безлимитным
орхидея: орхидей
город: городах города
каникулы: каникулы
сергиев: сергиев
полупансион: полупансион
тысяча: тысячи
стекло: стекол
астрахань: астрахань
провайдер: провайдер
чека: чека
профессиональный: профессиональное
номер: номер
биглион: биглионе биглион
google: google
распродажа: распродажи
билет: билет билетов
вакансия: вакансии
помогать: поможет
жуковский: жуковский
роза: роз
напрямую: напрямую
загружать: загрузить
краснодар: краснодар
иваново: иваново
любой: любые любом
family: family
часть: часть
скобелевский: скобелевская
рижский: рижская
калуга: калуга
грузовичкоф: грузовичкоф
парк: парк
письмо: письмо
отпечаток: отпечатку
viber: viber
многое: многое
выгодный: выгодной
разный: разное
avrora: avrora
вопрос: вопросы
изготовление: изготовление
store: store
александр: александръ
мир: миру мир
пари: пари
санаторий: санатории
skyeng: skyeng
пахра: пахры
удар: удара
волос: волосами
серьезный: серьезного
публичный: публичная
ждать: ждут
информация: информация
коробка: коробке
красный: красная
скалодром: скалодромы
заказ: заказ
место: месте
club: club
geekbuying: geekbuying
заезд: заезд
festival: festival
фотокнига: фотокниги
геленджик: геленджик
московский: московская
радость: радостью
быстро: быстрее
пляжный: пляжный
взрослый: взрослых
фото: фото
якитория: якитория
кафе: кафе
шляпный: шляпной
цветной: цветной
раменское: раменское
tvoi: tvoi
квеста: квесты
барбершоп: барбершопы
оздоровительный: оздоровительный
telegram: telegram
марьино: марьино
гортензия: гортензий
ограничение: ограничения
подружка: подружка
работать: работает
развлекательный: развлекательные
лобня: лобня
подбор: подбор
й: й
app: app
квадроцикл: квадроциклы
такой: таких
пейнтбол: пейнтбол
разумный: разумной
троицк: троицк
нижний: нижний
пр: пр
косметология: косметология
комплекс: комплексе
хризантема: хризантем
lesnoy: lesnoy
возврат: возврат
код: код
москва: москва москвы москве
видный: видное
антикафе: антикафе
концерт: концерты
бильярд: бильярд
полет: полеты
волгоград: волгоград
омск: омск
алтуфьево: алтуфьево
королев: королев
охотный: охотный
подарок: подарки
крытый: крытом
золотой: золотое
ола: ола
дома: дома
авто: авто
рязань: рязань
удаление: удаление
ярославль: ярославль
февраль: февраль февраля
aristokrat: aristokrat
казань: казань
спасибо: спасибо
близкие: близких
зуево: зуево
мало: меньше
cладкий: cладкий
год: лет
переславль: переславль
люберцы: люберцы
сувенирный: сувенирная
суздаль: суздаль
кондиционер: кондиционера
fitness: fitness
великий: великий
карта: карте
ирис: ирисов
способ: способ
иностранный: иностранные
гарантия: гарантия
поиск: поиск
сэкономить: сэкономить
череповец: череповец
банк: банк
стоматология: стоматология
питбайка: питбайки
мытищи: мытищи
твердый: твердой
платить: платите
кавказ: кавказ
тверь: тверь
целый: целый
коттедж: коттедже
лента: лента
река: реки
сочи: сочи
индивидуальный: индивидуальных
преимущество: преимущества
узи: узи
выгодно: выгодно
пользовательский: пользовательское
боулинг: боулинг
дайвинг: дайвинг
гринвуд: гринвуд
сервис: сервисах
modis: modis
бюджет: бюджету
обратно: обратно
поволжье: поволжье
маркет: маркет
sushishop: sushishop
воронеж: воронеж
находиться: найдется
звонок: звонка
сделать: сделать
большой: большой
кл: кл
эпиляция: эпиляция
цска: цска
шиномонтаж: шиномонтаж
катание: катание
химчистка: химчистка
танец: танцы
кт: кт
устройство: устройств
урал: урал
зеленоград: зеленоград
блог: блог
bookriver: bookriver
пребывание: пребывания
adidas: adidas
чита: чита
