татьяна: татьяна
свежий: свежие
стыдно: стыдно
красноум: красноум
нежели: нежели
ковид: ковид ковида
луковый: луковый
элемент: элементы
орган: органы
жить: живет
читать: читай читайте читать
сетка: сеткой
преть: преют
повреждать: повредив повредить
сталкиваться: сталкиваться
дом: дом
leave: leave
бытовой: бытовая
детский: детских детское
подробно: подробно
оставаться: остаются
иметь: имеет
карта: карта
одежда: одежды одежда одежду
щепка: щепка
прибор: приборов
домоводство: домоводства
прочитывать: прочитай
испортить: испортить испорченное
женщина: женщин
инфо: инфо
отвечать: ответить
кожа: кожи
вылечивать: вылечить
грибок: грибок
т: т
новый: новой новая
инструмент: инструменты
некоторые: некоторых
навигация: навигация
химчистка: химчистки
корень: корень
многие: многие многим
краска: краски
определять: определили
резинка: резинка резинку
шкаф: шкафу
хороший: лучшие
железа: железы
стоять: стоит
предотвращать: предотвратить
давать: дает дай
витрина: витрине
потливость: потливость потливости
решать: решить решено
чистка: чистка
идея: идеи
частность: частности
накрахмаливать: накрахмалить
норма: нормы
условие: условиях
последствие: последствия
день: дней
щепетильный: щепетильный щепетильная
настолько: настолько
бассейн: бассейна бассейн
аромат: аромат аромата
прослужить: прослужили
ребенок: детей
давление: давление
подборка: подборку
стойкость: стойкость
спортивный: спортивная
сожаление: сожалению
украшение: украшения
возникать: возникающих возникают
улица: улице улицу
гигиена: гигиена гигиены
помост: помост
нога: ноги ног
стоп: стоп
человек: человеку людей человека
особенность: особенности
платье: платье платьями
обратный: обратная
средство: средств средство средства
сигнализировать: сигнализирует
множество: множество
запись: записям записи
обязательный: обязательны обязательна
обувь: обувь обувью обуви
почитать: почту
полезный: полезных полезный
девушка: девушек девушка
судьба: судьбы
wordpress: wordpress
удобный: удобным
изменяться: изменились изменился изменяется
появление: появление появления
случай: случай случаи
коронавирус: коронавируса коронавирусом коронавирус
хозяйка: хозяйка
бромгидроз: бромгидроз
изменение: изменение изменения
ирина: ирина
тематический: тематических
признак: признак
пора: порой
запах: запахи запах запахов запаха
светоотражающий: светоотражающую
кроссовок: кроссовки кроссовок
грибковый: грибковое
делать: делать
смотреться: смотрится
проект: проекте
каждый: каждое
жевательный: жевательная жевательную
действенный: действенных
эффективный: эффективных эффективный
здоровье: здоровье
который: которых которые
парень: парень
кроме: кроме
днище: днище
лайфхаки: лайфхаки
трава: травы
надпись: надписи
узнавать: узнать узнайте
жаловаться: жалуются
заглядывать: заглянуть
язык: языке
акссесуар: акссесуары
поверхность: поверхности
кошачий: кошачьей
незадача: незадача
рецепт: рецептов рецепты рецепта рецепт
сч: сч
физиология: физиологии
обсуждать: обсудим обсуждаем
вода: воды
источник: источник
игра: игры
врач: врачу врача
чудесно: чудесно
многотонный: многотонной
skip: skip
состояние: состояние состояния
вовсе: вовсе
связь: связь
проблема: проблем проблему
легкий: легкая
неприятно: неприятно
несколько: нескольких
туфля: туфли
бассейнов: бассейнов
wen: wen
поражать: поражать поражает
крахмалить: крахмалить
ботинок: ботинки ботинками
микоз: микоз
вонять: воняют воняли воняет
совет: советы совета совет советов
мебель: мебель
просто: просто
постараться: постарались
торжество: торжества
внутренний: внутренних
необычный: необычный
подошва: подошв подошву подошве
дискомфорт: дискомфорт
theme: themes
характерный: характерного
проявление: проявления
нарушение: нарушений
народный: народные
система: системы
отзыв: отзывы
мочь: мог мочи
распрощаться: распрощаться
ремонтировать: ремонтировать
своевременный: своевременное
белый: белая белой белую
устранять: устранить
группа: групп группы
сложность: сложности
статья: статье статью
другой: другие другое
грамотно: грамотно
болезнь: болезни
потеть: потеют потели
материал: материалов
резкий: резким
неужели: неужели
фактор: фактор факторов
горячность: горячности
ошеломлять: ошеломляющий
переболеть: переболевшие переболевших
доводить: доводит
компактно: компактно
пошехонский: пошехонским
благоустройство: благоустройство
глажка: глажка
меняться: меняется
тема: тема
повышенный: повышенная
подводить: подводят
визитный: визитных
covid: covid
задумываться: задумывается
становиться: становится стал
пятно: пятна
самый: самый
пахнуть: пахнут пахнет
прямо: прямо
немедленно: немедленно
вс: вс
имя: имени
тот: тех
подобранный: подобранное
лайфхаков: лайфхаков
тело: тела
выпускной: выпускное
существовать: существует
также: также
сопровождаться: сопровождается
форум: форумах форумов
экод: экодом
переставать: перестань
каркасный: каркасный каркасных
проверять: проверенные
решение: решение
ножницы: ножницы ножниц
powered: powered
процесс: процессы процесса
атлас: атласа
снимать: снимать
неприятный: неприятный неприятного
уход: уход
подросток: подросток
единственный: единственное
удобно: удобно
content: content
сайт: сайта сайте
легко: легко
эстетично: эстетично
опасный: опасные
чистюля: чистюли чистюля
правильный: правильные
многообразие: многообразие
ловить: лови
шевелюра: шевелюру
носок: носки
наличие: наличии
неприятность: неприятности
верный: верное
сергей: сергей
муж: муж
обращаться: обратиться
куртка: куртку
загрязнение: загрязнения
воротничок: воротнички
экосредство: экосредства
изменять: изменить
подложка: подложка
ольга: ольга
патологический: патологическое
некачественный: некачественной
использовать: используй использованы
жизнь: жизни
карточка: карточек
ситуация: ситуации
активный: активная активные
конструкция: конструкции
дно: дно
граница: границы
произвол: произвол
это: это этим
дезинфекция: дезинфекция
кухня: кухне
черный: черные
вязаный: вязаными
отчаяние: отчаянии
дальнейший: дальнейшие
заболевание: заболевание
ясно: ясно
сыр: сыром
стирать: стирать
физиологический: физиологические
женский: женского женские
ссылка: ссылка
специфический: специфического специфический
таблица: таблицы
выход: выхода
повседневный: повседневный
рассказывать: рассказываем расскажем
линия: линии
дизайнер: дизайнеров
диван: дивана
приходиться: приходится
кажется: кажется
организм: организма
спецпроект: спецпроекты
подъюбника: подъюбники
говорить: говорить
политика: политика
крыться: кроется
амбра: амбре
лечение: лечение
время: время
разный: разных
безумие: безумия
появляться: появляются
жалко: жалко
гость: гостях
добираться: добраться
техника: техника
уборка: уборка уборки
екатерина: екатерина
сила: силу
причина: причины
написать: написал
волос: волосах волос
поговорить: поговорим
парфюм: парфюм
комментарий: комментарии комментария комментариев
встреча: встрече
особый: особый
момент: момент
помощь: помощи
любимый: любимые
пот: пота
данный: данного данную
маленький: маленькой
чистый: чистая
вопрос: вопрос
способный: способны способна способных способно
нос: носа
мужчина: мужчин
дидух: дидух
прогулка: прогулках
деловой: деловой
преддверие: преддверии
выделение: выделением
вирус: вирус
многий: многих
сохранять: сохранить
защищать: защитить
сколько: сколько
интерьер: интерьера интерьер
подписываться: подписывайтесь
оценка: оценки
участок: участка
недостаточный: недостаточной
препарат: препаратов
свидание: свидание
происходить: происходит
далее: далее
метод: методы
покой: покоя
гардероб: гардероб
хвататься: хвататься
текстиль: текстиль
развод: разводы
многое: многое
подол: подолы
изделие: изделиями изделий
носить: носить
стирка: стирка
парикмахер: парикмахера
страдать: страдайте
куча: кучу
нагрузка: нагрузки
жвачка: жвачку
суть: сути
вид: видов
лишь: лишь
цвет: цвет
копирование: копировании
помогать: помогите
толковый: толковые
избавление: избавления
эксперт: эксперты
шкафчик: шкафчиков
правильно: правильно
надувной: надувных надувной
какой: какие
выделительный: выделительные
резко: резко
разбирать: разберем
фото: фото
эффективно: эффективно
постковидный: постковидного
обоняние: обоняния
наблюдаться: наблюдаются
каков: каковы
хранение: хранение хранения
вирусный: вирусное
умещать: уместить
аптека: аптеках
старый: старыми
удалять: удалить
свадебный: свадебное
отчаиваться: отчаиваться
зачастую: зачастую
след: следы
джут: джута
подбирать: подобрать
прилипать: прилипшую
домашний: домашних домашний
учебник: учебники
подробный: подробной
странный: странный
наталья: наталья
нечего: нечего
держать: держать
line: line
ярлычок: ярлычках
прибегать: прибегая
выдерживать: выдерживают
взрослый: взрослое
позаимствовать: позаимствованы
далеко: далеко
большой: большие
обзор: обзор
психологический: психологический
энциклопедия: энциклопедия
внимание: внимания
год: лет
долгий: долгое
способ: способом способ способов
русский: русском
однако: однако
обговаривать: обговорим
часто: часто
стрижка: стрижке
хотеться: хочется
организация: организации
восприятие: восприятие
мышка: мышками
секрет: секреты
аноним: аноним
оставлять: оставлять
поиск: поиск
чаша: чаши
предупреждать: предупредить
экожизнь: экожизнь
небольшой: небольшая
конфиденциальность: конфиденциальности
убирать: убрать
продукт: продуктов
вариант: варианты вариантов
находить: найти
обращать: обращают
подкладывать: подложить
новогодний: новогоднее
поражение: поражение
прокол: проколов
почему: почему
trade: trade
химия: химии
обозначение: обозначения
нести: несет
сделать: сделать
вещь: вещей
посещение: посещение
английский: английские
пвх: пвх
подготовить: подготовили
потайной: потайных
один: одна
бороться: бороться
сразу: сразу
comment: comment
комод: комод
отмывать: отмыть
