реферат: рефераты
свыше: свыше
россия: россии
блог: блоги
жизнь: жизни
добро: добро
гумил: гумил
сервис: сервисов
победитель: победитель
содержать: содержит
связь: связь связи
славянский: славянскому
столетие: столетиям
включать: включено
это: это
планка: планка
приводиться: приводятся
сайт: сайт сайты сайте сайта
факт: фактов
князь: князей
отдельный: отдельной
раздел: раздел разделы разделе
разбивка: разбивкой
производить: производил
грабить: грабили
достоверность: достоверности
аналитика: аналитика
количество: количество
тема: темам темы
коммент: комментов
создавать: созданных
краткий: краткое кратких
читать: читая
например: например
список: список
приложение: приложения
ответ: ответ ответа
карта: карты карт
учебник: учебников учебниках
источник: источников источники
фрагмент: фрагменты фрагментов
познавательный: познавательные
комментарий: комментарии комментариев
пользователь: пользователей
серия: серия серии
оставаться: останется
макс: макса
статья: статей статьи
воевать: воевали
информация: информацию
л: л
конкурс: конкурса
человек: люди людей
некоторые: некоторых
событие: событий
первоисточник: первоисточников
пассионарность: пассионарности
lifeofpeople: lifeofpeople
соловьев: соловьева
система: систем
текущий: текущую
новость: новости
исторический: исторических
е: е
текст: тексты
частность: частности
вопрос: вопроса вопросу
н: н
точка: точки
зрение: зрения
иной: иных иным
эссе: эссе
другой: другому
расч: расч
разорять: разоряли
невольно: невольно
править: правили
открывать: открыт
любой: любой
баланс: баланс
авторский: авторском авторские
документ: документов
материал: материалах материалы
страница: странице
оформлять: оформлены
помогать: помочь
золотой: золотой золотым
использоваться: используются
описание: описание описаний
обратный: обратная
ва: ва
номинация: номинации
info: info
два: двум
устройство: устройстве
дзен: дзен
искать: искать
м: м
ряд: ряд
интернет: интернет
сторона: сторон
конспект: конспектов конспекты
полезный: полезных
отбирать: отобрано
царь: царей
этнический: этнических
теория: теории
история: истории история
всероссийский: всероссийского
также: также
находить: найти
изымать: изъять
толстой: толстой
соловить: соловь
приходить: приходишь
лев: льва
хронология: хронологии
блок: блок
пользовательский: пользовательское
историк: историков
сочинение: сочинении
война: войнах
аргументированный: аргументированных
сегодня: сегодня
размещать: размещены
см: см
канал: канал канале
многий: многих
livejournal: livejournal
xiii: xiii
встарь: встарь
жить: жили
речь: речь
цель: целей
тысяча: тысяч
старославянский: старославянском
статистика: статистику
группа: группам
книга: книг
соглашение: соглашение
народ: народам
яндекс: яндекс
свидетельство: свидетельств
этнос: этносам
житие: житии
каждый: каждому
который: которых
автор: автора
реестр: реестр
проект: проектов
один: одна
формула: формулой
тег: теги
разбой: разбоях
язык: языке
десять: десяти
сечение: сечением
схема: схемы
размещаться: размещаются
пожаловать: пожаловать
мир: миру
наверх: наверх
тов: тов
альтернативный: альтернативные
