непревзойденный: непревзойденной
россия: россии
автохимия: автохимия
универсальность: универсальностью
caterpillar: caterpillar
ponsse: ponsse
schmitz: schmitz
июн: июн
платон: платон
добывающий: добывающей
shantui: shantui
expo: expo
kyrgyzstan: kyrgyzstan
экскаватор: экскаватор
справочный: справочную справочно
четер: четра
аналог: аналог
автотранспортный: автотранспортной
погрузчик: погрузчики
российский: российской российских
мзкт: мзкт
гсм: гсм
bw: bw
это: это
важный: важных
топливный: топливно топливные
мощность: мощности
здание: зданий
копирование: копирование
отрасль: отраслей отрасли
хороший: лучших
грейдер: грейдер
указание: указания
покупка: покупки
руководитель: руководителей
запрещать: запрещено
лесна: лесной
russia: russia
транспорт: транспорта
scania: scania
мегаполис: мегаполис
hyundai: hyundai
главный: главная
тема: темы
сооружение: сооружений
книга: книги
оборудование: оборудование
год: года
карта: карты
находить: найдете
показывать: показать
камазовец: камазовцы
июнь: июнь
апрель: апрель
контакт: контакты
весь: весь вся
neo: neo
автошина: автошины
инфраструктура: инфраструктуры
система: система системы
сентябрь: сентябрь
портал: портале портал портала
информация: информацию
дорога: дороги дорог
автобус: автобусы автобус
ремонт: ремонт
евро: евро
техобслуживание: техобслуживание
запасной: запасных
спецтехника: спецтехника спецтехнике спецтехники
daewoo: daewoo
сельскохозяйственный: сельскохозяйственная сельскохозяйственные
основной: основные
материал: материалов
новость: новости
современный: современный
нефаз: нефаз
техника: техника техники
bauma: bauma
мост: мостов
март: март
вездеходный: вездеходная
valmet: valmet
ориентированный: ориентированный
профессиональный: профессиональный
июль: июль
поставщик: поставщиках
ба: ба
оренбург: оренбурга
строительный: строительная
освещать: освещающие
тонар: тонар
аренда: аренда
инженер: инженеров инженер
предприятие: предприятий
специализированный: специализированный
грузовой: грузовые грузовых
урба: урб
fruehauf: fruehauf
выбор: выбора
число: числе
август: август
октябрь: октябрь
автогрейдер: автогрейдеры
другой: других
грузоперевозка: грузоперевозки
газ: газ
ной: ноя
автомобиль: автомобили автомобилей
kia: kia
нюанс: нюансы
май: май
китайский: китайские
энергетический: энергетической
выставка: выставке выставка выставки
окт: окт
импортный: импортной импортных
информационный: информационный
проектирование: проектирования
статья: статьи
комплектующий: комплектующих
маз: маз
дорожный: дорожно дорожная
защищать: защищены
декабрь: декабрь
серия: серии
февраль: февраль
сено: сен
использование: использованием
технодрев: технодрев
специальный: специальной
doosan: doosan
деятельность: деятельность
производственный: производственных
лес: леса
целое: целом
komatsu: komatsu
справочник: справочник
архив: архивы архив
оператор: оператора
комфорт: комфортом
также: также
газель: газель
nissan: nissan
бульдозер: бульдозеры
мониторинг: мониторинга
публикация: публикаций
производство: производство
связанный: связана
ноябрь: ноябрь
паз: паз
строительство: строительства
deere: deere
москва: москвы
благоустройство: благоустройства
интервью: интервью
фев: фев
воронеж: воронежа
запчасть: запчасти запчастей
карьерный: карьерные
коммерческий: коммерческого
ссылка: ссылки
шантуй: шантуй
камаз: камаз
утк: утк
бренд: бренды
производитель: производителях
легко: легко
правительство: правительство
министерство: министерство
ооо: ооо
ведущий: ведущих
copyright: copyright
показатель: показателями
ресурс: ресурс
который: которых
источник: источника
публиковаться: публикуются
дилер: дилеры
электробус: электробус
jcb: jcb
часть: частях
скрывать: скрыть
лесозаготовительный: лесозаготовительная
полезный: полезную
популярный: популярные
спутниковый: спутникового
разный: разными
дальний: дальний
специалист: специалистов
запускать: запустили
тег: теги
январь: январь
новый: новые
янва: янв
право: права
москвич: москвич
урал: урал
партнер: партнеры
беларус: беларус
kobelko: kobelko
вопрос: вопросы
восток: восток
john: john
прицеп: прицепы
грузовик: грузовиков
