женщина: женщина
кодекс: кодекса
разрабатывать: разработано
рф: рф
ваш: вашего ваше ваших ваш
продолжать: продолжить продолжая
самарский: самарская
свердловский: свердловская
e: e
подробно: подробнее
снова: снова
name: name
treat: treat
урологический: урологических
челябинский: челябинская
получение: получение
contact: contact
компания: компании компания
добавлять: добавлен добавить
менеджер: менеджера
локализация: локализация
раскрытие: раскрытие
характер: характер
mail: mail
приборный: приборный
актуальный: актуальную
результат: результат
карта: карта
обращать: обращаем
знание: знания
ивановский: ивановская
almag: almag
обязательный: обязательные
крым: крым
санаторий: санаториев
область: область области
отправлять: отправить
ответ: ответ
казахстан: казахстан
зарегистрироваться: зарегистрироваться
аппарат: аппарата аппарат
решение: решения
пензенский: пензенская
т: т
пол: пол
костромской: костромская
входить: входят войти
двигательный: двигательного
эл: эл
поддержка: поддержка
дагестан: дагестан
северный: северная
корзина: корзину корзина
оренбургский: оренбургская
технический: техническим технический
партнер: партнерам
оферта: офертой оферта
измерение: измерения
якутия: якутия
лечение: лечения лечении
публикация: публикации
рекомендовать: рекомендованный рекомендованная
н: н
условие: условиями условиях
социальный: социальная
врач: врача врачу врач врачам
личный: личный
пользование: пользования
сахалинский: сахалинская
ребенок: детей
всемирный: всемирный
потребитель: потребителем
осетия: осетия
материал: материалов материалы
тыва: тыва
консультация: консультации
здравоохранение: здравоохранения
выбор: выбор
подготовительный: подготовительными
развитие: развития развитию
система: система
новосибирский: новосибирская
обратный: обратная
регион: региона регион
магазин: магазинов
алтайский: алтайский
алтай: алтай
device: device
производство: производстве производства производство
проектировать: проектируем
каталог: каталог
предложение: предложений предложениях
р: р
предприятие: предприятия
validation: validation
интернет: интернет
международный: международным международная международный
sex: sex
приморский: приморский
отчетность: отчетность
полностью: полностью
давать: даете
выпускать: выпускаем выпускаемой
protected: protected
карелия: карелия
магнитобиология: магнитобиологии
медицинский: медицинское медицинского медицинский медицинских медицинскую
улица: улица
смочь: смогли
стоимость: стоимости
itech: itech
внимание: внимание
продолжительность: продолжительность
который: которые
расходный: расходные
представлять: представленная
uf: uf
касимовский: касимовский
источник: источник
гарантия: гарантии
смоленский: смоленская
чувашский: чувашская
ф: ф
пресса: пресса
кабинет: кабинет
связь: связь
проблема: проблем
производственный: производственная
работник: работника
гарантийный: гарантийные
cookie: cookie
работа: работами работы
команда: команде
хороший: лучших
ответственность: ответственность
рязанский: рязанская рязанской
здоровье: здоровья
мебель: мебель
калмыкия: калмыкия
нтц: нтц
ненецкий: ненецкий
бурятия: бурятия
комментарий: комментарий
текст: текст
оборудование: оборудование
рассрочка: рассрочку
коми: коми
человек: человек
продукция: продукцию продукция продукции
site: site
удмуртский: удмуртская
орловский: орловская
петербург: петербург
язык: язык
информация: информацию информации информация
елатомский: елатомский
свой: свой
выгодный: выгодных
техника: технику
данный: данных данный
товар: товара товаров товар
показывать: показывать
pretenziya: pretenziya
г: г
поликлиника: поликлиник
весь: вся
магаданский: магаданская
доставка: доставка
инвестиционный: инвестиционные
еврейский: еврейская
башкортостан: башкортостан
разработка: разработка разработки
томский: томская
купить: купить
файл: файлов файлы
руководство: руководство
научный: научная научные научный
янин: янина
др: др
научно: научно
apply: apply
наименование: наименований
региональный: регионального
санкт: санкт
тульский: тульская
персональный: персональных
размещать: размещенная
тема: тема
год: года год
российский: российская российского российской
край: край
помогать: помогают
давление: давления
лор: лор
публичный: публичной публичная
внутриглазной: внутриглазного
вопрос: вопроса вопрос вопросам
вологодский: вологодская
какой: каких
псковский: псковская
рынок: рынке
создавать: создает создающая
изготовлять: изготавливаем
воронежский: воронежская
сертифицировать: сертифицированном сертифицирована сертифицируем
диагноз: диагноз
еламед: еламед
комплексный: комплексного
претензия: претензий
склад: складе
age: age
переходить: перейти
взаимодействие: взаимодействие
карачаево: карачаево
использование: использования использование использовании
ru: ru
сайт: сайта сайт сайте сайтом
заболевание: заболеваний заболевания
тверская: тверская
история: история
проводить: проведено проводим
en: en
адрес: адреса адрес
пермский: пермский
жалоба: жалоб
дополнительный: дополнительного
телефон: телефона телефон
курская: курская
наличие: наличии наличия
возраст: возраст
основа: основе
защита: защиты
наш: наш нашу нашей
татарстан: татарстан
hh: hh
сервисный: сервисные
автономный: автономный автономная
ямало: ямало
центр: центр центры
правило: правила правилах
учреждение: учреждений
больница: больниц
дата: дата
неделя: неделе
карьера: карьера
мурманский: мурманская
нижегородский: нижегородская
день: день днем дня
критерий: критериям
ростовский: ростовская
приобретать: приобретенный приобретен
курганский: курганская
kz: kz
elamed: elamed
пос: пос
профилактический: профилактических
обработка: обработки
кировский: кировская
оснащение: оснащения
соцсеть: соцсетях
уточнять: уточнить
форма: форма
замена: заменой
положение: положениями
r: r
забайкальский: забайкальский
ставропольский: ставропольский
новгородский: новгородская
оплата: оплата
бережный: бережного
прямой: прямой
калужский: калужская
новость: новости
политика: политика
указание: указание
заниматься: занимаемся
ознакомлять: ознакомлен
согласный: согласен
com: com
пресс: пресс
продукт: продукты
исследование: исследования исследований
пациент: пациента
балкарский: балкарская
марья: марий
саха: саха
чеченский: чеченская
забывать: забыли
информационный: информационный
использоваться: используются
group: group
стандарт: стандарт
ленинградский: ленинградская
мигрень: мигрени
хабаровский: хабаровский
глубокий: глубокие
отмечать: отмечает
алания: алания
тюменский: тюменская
обязательство: обязательства
пароль: пароль
деятельность: деятельность
владимирский: владимирской владимирская
служить: служить
основание: основания
заказывать: заказать
амурский: амурская
домашний: домашнее
профессиональный: профессиональное
номер: номер
инновация: инноваций
term: terms
адыгея: адыгея
google: google
процедура: процедура
регистрация: регистрации регистрация
клинический: клинические
россия: россия
наука: науки
непрерывный: непрерывное
волгоградский: волгоградская
брянский: брянская
использовать: использовать
прототипировать: прототипируем
астраханский: астраханская
лечебный: лечебно
firsterror: firsterror
п: п
дайджест: дайджест
завод: завод
общий: общим
recaptcha: recaptcha
изделие: изделия изделий
мансийский: мансийский
достижение: достижения
никитин: никитина
проктологический: проктологических
заполнение: заполнения
localization: localization
поле: поля
опорный: опорно
задавать: задать
тамбовский: тамбовская
кабардино: кабардино
сбор: сбора
являться: является
меленки: меленки
цифра: цифрах
калининградский: калининградская
ханты: ханты
подход: подход
красноярский: красноярский
московский: московская
покупка: покупки
пользоваться: пользоваться
награда: награды
duration: duration
контакт: контакты
камчатский: камчатский
иркутский: иркутская
метаданные: метаданных
качество: качества
iso: iso
белгородский: белгородская
серийный: серийный
мужчина: мужчина
округ: округ
хакасия: хакасия
ознакомительный: ознакомительный
privacy: privacy
согласие: согласие
версия: версия
отрасль: отрасли
дома: дома
исключительно: исключительно
подписываться: подписаться подпишитесь
рассылка: рассылку
policy: policy
республика: республика
база: базу
лицензия: лицензии
чукотский: чукотский
архангельский: архангельская
procedure: procedure
бесплатный: бесплатные
фундаментальный: фундаментальный
кемеровский: кемеровская
очный: очной
мордовия: мордовия
статья: статьи
черкесский: черкесская
носить: носит
service: service
узнавать: узнавайте
обязательно: обязательно
поиск: поиск
беларусь: беларусь
покупатель: покупателям
температура: температуры
конфиденциальность: конфиденциальности
ингушетия: ингушетия
вебинара: вебинары
необходимо: необходимо
первый: первыми
мониторинг: мониторинга
липецкий: липецкая
гражданский: гражданского
звонок: звонок
сотрудник: сотрудники
самый: самую
севастополь: севастополь
ссылка: ссылки
имя: имя
алмаг: алмаг
москва: москва
касаться: касающаяся
регистрировать: регистрируем
ярославский: ярославская
определять: определяемой
омский: омская
восстанавливать: восстановить
лпу: лпу
устройство: устройств
краснодарский: краснодарский
саратовский: саратовская
елатьма: елатьма
ульяновский: ульяновская
директор: директор
оценка: оценка
diagnosis: diagnosis
среди: среди
