полезный: полезными полезные полезная
вид: виды видов
отличать: отличить
вода: воды
источник: источник
пастеризация: пастеризация
снижать: снизить
население: населения
производство: производствах
появляться: появился
обычно: обычно
волна: волн
продукт: продукт продукта продуктов продукты
рождение: рождения
встречать: встретив
питайя: питайя
каша: каши
ценность: ценности
пища: пище пищи
фраза: фразу
состояние: состояние
фрукт: фруктов фрукты фрукт
являться: является
здоровье: здоровьем здоровья здоровье
дело: деле
проблема: проблем
информация: информацию информация
это: это
замечательный: замечательное
важный: важная важную
грот: грот
голубой: голубой
ребенок: дети
порошок: порошка
различный: различных различные
достаточно: достаточно
именно: именно
прага: прага
улучшение: улучшению
поскольку: поскольку
растение: растений
попробовать: попробовать
причина: причиной
специя: специи
ниже: ниже
дневный: дневного
холодный: холодных
любить: любят
морепродукт: морепродукты
сад: сад
город: город
случайно: случайно
фруктоза: фруктоза
главный: главная
кумыс: кумыса кумыс
огород: огород
супермаркет: супермаркетов
банан: банан бананы
питахайя: питахайя
какой: какую
непривычный: непривычных
запись: записям
растительный: растительные растительных
зрение: зрения
великолепный: великолепна
планета: планеты
видео: видео
получать: получают
выращивать: вырастить
giperinfo: giperinfo
наш: нашей наши нашего
называть: назвать
удаленный: удаленных
свойство: свойства
услышать: услышать
ku: ku
спред: спреда
волшебный: волшебная
значительный: значительное
проникать: проникает
популярный: популярных
человек: человеке человеком человека
высокий: высокой высокое
приобретать: приобрел
влиять: влияют
зря: зря
некоторые: некоторых
горячий: горячих
употребляться: употребляется
товар: товара
один: одним
становиться: стать
аминокислота: аминокислот
навигация: навигация
coiarurm: coiarurm
творог: творога творог
относиться: относятся
способствовать: способствуют
говорить: говорят
многие: многие
сбалансировать: сбалансированного
витамин: витамина витамины
масло: масла масел масло
падать: падают
знать: знаем
свет: свет
делаться: делаются
далекий: далекие
молоко: молоко молока молоком
жир: жиры жиров
жирный: жирные
светить: светила
считаться: считаются считается
сквозь: сквозь
замок: замков
семя: семян
очень: очень
отверстие: отверстие
публикация: публикации
ягода: ягодам ягода
потребление: потребление
рыба: рыба
время: время
кислота: кислоты
сливочный: сливочное
солнечный: солнечный
луч: лучи
кондитерский: кондитерские
острый: острым
агар: агар
кровь: кровь
ботанический: ботанической
мясо: мясо
затапливать: затопленную
оказывать: оказывают
играть: играют
белок: белок
обогащать: обогащают
другой: других
вкусный: вкусная
бакалея: бакалея
ассортимент: ассортимент
маргарин: маргарин
углевод: углеводов
этикетка: этикетка
регулярно: регулярно
питание: питания
энергетический: энергетической
пример: примеров
вкус: вкус
часто: часто чаще
ожирение: ожирения
использоваться: использоваться используются
оздоравливать: оздоравливает
статья: статьи
состав: состав
самый: самой самом самый самых
содержать: содержат
давно: давно
орех: орехи орех
овощ: овощи
пастеризовать: пастеризованное
страна: страны
обязательно: обязательно
сам: самого
крупа: крупы
мочь: могут
есть: едим
изделие: изделия
конец: концов
сок: соки
свекла: свекла
употребление: употребления
тело: тела
довольно: довольно
http: https
вообще: вообще
влияние: влияние
также: также
находить: найти
youtu: youtu
море: морем
выдаваться: выдаются
день: дни
питательный: питательными
закуска: закуска
точка: точки
портал: портал
польза: польза
дворец: дворцов
вместо: вместо
современный: современных
недавний: недавние
мясной: мясные
хлеб: хлеб
который: которые которую
любой: любое
тунец: тунец
пыхать: пышущем
пестреть: пестрит
ru: ru
поверхность: поверхностью
информационый: информационый
салат: салата
молочный: молочные
история: история
слишком: слишком
болезнь: болезней
большой: большую
сердце: сердца
вред: вред
лакомство: лакомство
единственный: единственное
зимний: зимняя
экзотика: экзотикой
путешествие: путешествия
часть: часть
вредный: вредных
уровень: уровень
блюдо: блюд
распространять: распространенные
помогать: помогает
далее: далее
чай: чай
популярность: популярность
богатый: богатый
экзотический: экзотические
приготавливать: приготовить
пещера: пещеру
приготовление: приготовлении
кофе: кофе
чрезвычайно: чрезвычайно
комбинация: комбинации
оно: оно
авокадо: авокадо
плод: плодов
грецкий: грецкий
несколько: несколько
творожный: творожный
сделать: сделано
деликатес: деликатесы
ценить: ценят
драконий: драконий
природный: природный
мир: мире
ряд: ряда
сахар: сахара
разнообразный: разнообразного
посещать: посещать
b: b
роль: роль
среди: среди
рецепт: рецепт
