ваш: вашего вашем
рост: рост ростом
рф: рф
население: населения
e: e
онлайн: онлайн
рыбный: рыбного
обоснование: обоснование
правильный: правильного правильное
получение: получение
добавлять: добавить
российский: российской российских
браузер: браузеров браузера
лицо: лицо лиц
долго: дольше
вид: вид
mail: mail
физиологический: физиологических
продукт: продуктах продуктов
поделиться: поделитесь
полный: полное
хороший: хорошего
большинство: большинстве
главный: главная
пол: полом пола
рацион: рацион рациона рационов
направление: направлению направление направлении
иметь: имеющие
эксперт: экспертов
карта: карты
воз: воз
зарегистрироваться: зарегистрироваться зарегистрируйтесь
т: т
телосложение: телосложение телосложения
приводить: приведет
новый: новейшим
заполнять: заполните заполнить
принадлежность: принадлежность
особенность: особенностями особенностям особенностей
система: систем система системы
комиссия: комиссией
анализ: анализа анализ
поддержание: поддержание поддержания поддержанию
животное: животного
формирование: формирования
решать: решить
охрана: охрана охране
пользователь: пользователям
такой: таким такая
прикладной: прикладное
норма: нормы норм
личный: личный
рейтинг: рейтинг
необходимый: необходимые
позволять: позволит
анкета: анкету анкета
функциональный: функциональное функционального
благодаря: благодаря
bsd: bsd
человек: людей человек человека
повышение: повышении
здравоохранение: здравоохранения
безопасность: безопасности
текущий: текущими
максимально: максимально
уникальность: уникальности
window: windows
донейшен: донейшен
просмотр: просмотр
состав: состава
параметр: параметрах параметры
мочь: можете
аллерген: аллергены
фактор: факторов факторы
урдла: урдла
справочная: справочная
прекрасный: прекрасному
представление: представление
диета: диета диет диеты
обязательный: обязательным обязательное
рассадник: рассадников
тип: типом
linux: linux
энергия: энергии
проводить: проведите проведенных
блюдо: блюд блюда
здоровье: здоровья здоровье
медицинский: медицинское
наш: нашего
располагать: расположенных
новое: нового
желание: желании
голос: голосов
всемирный: всемирной
суточные: суточных
бесплатно: бесплатно
вести: ведущей
ресурс: ресурсом ресурса
кафедра: кафедрах
россия: россии
отредактировать: отредактировать
проживать: проживет
rub: rub
рассчитать: рассчитанная рассчитанные
состояние: состояние состоянию состоянием
кабинет: кабинет
проектирование: проектирование проектирования
next: next
способствовать: способствовать
графический: графический
вы: вами
идеальный: идеальной идеального
разработка: разработок
размер: размер
раздел: раздел разделы разделе
оказывать: оказывающим
twitter: twitter
который: которого котором
ные: ные
запястье: запястья
алгоритм: алгоритмов алгоритмах алгоритмы
создавать: создана созданных
previous: previous
трудность: трудности
подраздел: подраздел
версия: версии
ссылка: ссылкой
государственный: государственном
университет: университете
v: v
здоровый: здоровой
свой: своего свой свои
похудение: похудение
случай: случае
г: г
условие: условия условиям условие
указывать: указывает
средство: средствах
упражнение: упражнений
ручной: ручного
инновационный: инновационных
технология: технологий
различный: различных различным
др: др
достаточный: достаточные
расч: расч
пищевой: пищевых пищевого
значимый: значимым
начинать: начатых
набор: набор
стоимость: стоимость
поддерживать: поддерживающих
компонентный: компонентного
описание: описание
запуск: запуска
производить: производить произвести
информация: информации информация
относиться: относится
наиболее: наиболее
тело: тела
потребность: потребностей
влияние: влияние
жеор: жеора
также: также
мак: мак
понимать: понять
расчет: расчета расчет
комплексный: комплексного
переходить: перейти
ru: ru
возможность: возможность возможностей
меню: меню
проявлять: проявить
нагрузка: нагрузками нагрузки
сайт: сайта сайт сайте
индивидуальный: индивидуальный индивидуальной индивидуальными индивидуальных
уровень: уровень
экспертный: экспертная
межведомственный: межведомственной
доступный: доступен
автоматизированный: автоматизированного автоматизированный
требование: требования
основа: основе
корректировка: корректировки
удовлетворять: удовлетворяющих
приготавливать: приготовьте
сырье: сырья
жизнь: жизни
редактирование: редактирование
первый: первом
это: это
вес: вес весом веса
получать: получите полученного полученных
формула: формул
профессия: профессией
калькулятор: калькулятор
данна: данной
значит: значит
таха: тах
женский: женского
концепция: концепциях
составлять: составить
таблица: таблицы
сан: сан
библиотека: библиотека
генетический: генетические
физический: физической физическими
уменьшение: уменьшения
создание: создание создания
операционный: операционных
федерация: федерации
whatsapp: whatsapp
пониматься: понимаются
организм: организма
рецепт: рецепта
основной: основные
некоторые: некоторым
назначение: назначение
федеральный: федеральных
лоренц: лоренца
уч: уч
научный: научное научные
исследование: исследованиям исследований
инженерный: инженерных
справочник: справочника
студент: студентов
пункт: пунктом
статус: статуса
статистика: статистика
таковой: таковые
улучшение: улучшения
процесс: процесса
вконтакте: вконтакте
питание: питание питания
эффективный: эффективное эффективной
забота: заботу
ekodiet: ekodiet
достигаться: достигается
группа: групп
индивидуализировать: индивидуализированных
кетля: кетле
харрис: харриса
слово: словами
помощь: помощи
данный: данного данный
соматотип: соматотипом
информационный: информационной информационных
масса: массы
метод: методах
образ: образ образом
сеть: сетях
помогать: поможет
давать: даст
программный: программное
бенедикта: бенедикта
уточнение: уточнением
окружающий: окружающей
профилактический: профилактического
trympampam: trympampam
происходить: происходит
другой: другими других
наследственность: наследственность
минимальный: минимальные
показатель: показателей
управление: управления
применение: применению
заботиться: заботиться
цель: целью цели
обеспечение: обеспечение
поле: поля
вариант: вариантов варианты варианта
увеличение: увеличения
моделирование: моделирования
государство: государства
антропометрический: антропометрические
являться: является
имт: имт
значение: значение
достаточно: достаточно
индекс: индекс
трудовой: трудовой
переработка: переработки
возникать: возникли
понимание: понимания
индивидульный: индивидульных
калорийность: калорийности
пользоваться: пользоваться
детерминированный: детерминированных
воронежский: воронежском
биотехнология: биотехнологий
x: x
браузерный: браузерное
контакт: контакты
тот: те та
принцип: принципы
зарегистрировать: зарегистрированным
устройство: устройству
современный: современные
е: е
вызов: вызовам
видеоурок: видеоурок
один: одном
все: всем
следить: следят
использовать: используемых используя
совет: совета
год: лет
миффилин: миффилина
pinterest: pinterest
деятельность: деятельности
регистрация: регистрации
хотя: хотя
организация: организации
статья: статьи
вещество: веществах
рука: руки
мужской: мужского
учет: учетом
понятие: понятия
кетч: кетч
соответствие: соответствии
самочувствие: самочувствия
проблема: проблема
входить: войти
вышеописанный: вышеописанных
пропорция: пропорция
составление: составления
определенный: определенному
фио: фио
macos: macos
комплекс: комплекс
возраст: возрастом
калория: калорий
технологический: технологической
facebook: facebook
среда: среды
результат: результатом
брок: брока
относить: относят
бесплатный: бесплатное
наверх: наверх
функционирование: функционирования
контактный: контактное
иметься: имеются
